,Channel_name,Title,Views,Likes,Comments,Published_date,Month,title_length,reaction
0,CodeWithHarry,5 Mind Blowing AI Tools You Wont Believe Existed (Use These) 🔥,85955,4694,1991,2023-07-09,Jul,62,6685
1,CodeWithHarry,Best Laptops to buy in 2023 (Buy these) 🔥 💻,109549,5236,709,2023-07-08,Jul,43,5945
2,CodeWithHarry,How to Actually Get a Job in Web Development (Get Hired) 👨‍💻,172848,12572,1250,2023-07-07,Jul,60,13822
3,CodeWithHarry,AWS Builders Online Series: Level up your Cloud Skills with AWS 🔥,29632,1319,169,2023-07-06,Jul,65,1488
4,CodeWithHarry,How to Adapt ChatGPT's Impact on Your Coding Journey 👩‍💻👨‍💻,68729,2953,262,2023-07-06,Jul,59,3215
5,CodeWithHarry,AI Workflow Automation | Automate all your tasks with this tool 🔥🔥,17370,880,87,2023-07-05,Jul,66,967
6,CodeWithHarry,Linux Cronjob Tutorial | Learn Linux Cronjobs 🔥,14405,613,130,2023-07-03,Jul,47,743
7,CodeWithHarry,MongoDB for Data Professionals | Data Analysis Tools in MongoDB 🔥,15135,599,99,2023-07-02,Jul,65,698
8,CodeWithHarry,Creating a Meme Coin Using Starton 🔥,16551,722,140,2023-07-01,Jul,36,862
9,CodeWithHarry,Lets Build a Stock Management System in using MongoDB 🍃 and Next.js 🔥,31179,1179,155,2023-06-30,Jun,69,1334
10,CodeWithHarry,A Dream Gadget for all Coders 😍😍😍,93297,4023,397,2023-06-29,Jun,33,4420
11,CodeWithHarry,50 Linux Commands Every Developer Must Know 🔥,30166,1499,176,2023-06-27,Jun,45,1675
12,CodeWithHarry,"UltraEdit Review: A powerful, flexible, and highly configurable text editing tool🔥",17232,657,126,2023-06-25,Jun,82,783
13,CodeWithHarry,HarryGPT - An AI Based Discord Bot 🔥 | Generative AI Series,37712,1526,181,2023-06-24,Jun,59,1707
14,CodeWithHarry,Web Scraping using Scrapy | Scrapy Tutorial + Storing Data to MongoDB 🍃,18423,588,144,2023-06-21,Jun,71,732
15,CodeWithHarry,"Lets Build a Dall-E Image Generator Using OpenAI, Flask & Replit | Generative AI Series 🔥",34089,1232,188,2023-06-19,Jun,89,1420
16,CodeWithHarry,Enabling HTTPS on Linode Using Certbot - A Step-by-Step Guide 🔥,15626,500,115,2023-06-16,Jun,63,615
17,CodeWithHarry,"Lets Build a Blog Using Appwrite Cloud, Next.js and Tailwind CSS - Step by Step Tutorial 🔥",21406,635,156,2023-06-14,Jun,90,791
18,CodeWithHarry,"Improving our Portfolio Website using HTML, CSS, JavaScript and React 🔥",67852,2374,243,2023-06-13,Jun,71,2617
19,CodeWithHarry,Clone any Audio using AI with this free tool (For Free) 🔥,96878,3927,282,2023-06-08,Jun,57,4209
20,CodeWithHarry,This Free AI Image generator will blow your mind!,258389,6045,342,2023-06-07,Jun,49,6387
21,CodeWithHarry,"Extracting Product Data from E-Commerce Website using Python, Requests and Live Proxies",23296,886,148,2023-06-05,Jun,87,1034
22,CodeWithHarry,"How to Host a Flask App on Linode for Production using uWSGI, Nginx & Ubuntu | Step-by-Step Tutorial",11785,410,96,2023-06-04,Jun,100,506
23,CodeWithHarry,Making money in Cybersecurity 💰,102848,9496,110,2023-06-04,Jun,31,9606
24,CodeWithHarry,How to Generate an NFT Collection using AI via Starton API?,20359,890,167,2023-06-02,Jun,59,1057
25,CodeWithHarry,"FastAPI Tutorial in Hindi | Lets build a Notes app using FastAPI, MongoDB & Bootstrap 🔥",35222,1501,160,2023-05-31,May,87,1661
26,CodeWithHarry,Hidden VS Code Feature 🔥,94781,8441,69,2023-05-28,May,24,8510
27,CodeWithHarry,Is Python really dead?? (The real truth) ☠️,292818,10747,823,2023-05-27,May,43,11570
28,CodeWithHarry,"Python Project: Creating a GUI Downloader Using Python, Requests and Tkinter 🔥",23204,931,171,2023-05-25,May,78,1102
29,CodeWithHarry,Your Browser is not Secure! (Here's Why),100349,5111,482,2023-05-21,May,40,5593
30,CodeWithHarry,"Personal Portfolio website using HTML, CSS and JavaScript (from scratch) 🔥",280406,8228,594,2023-05-19,May,74,8822
31,CodeWithHarry,"ChatGPT Clone using OpenAI, Flask, HTML, TailwindCSS, & MongoDB (Amazing Frontend Project) 🔥🔥",87463,3192,340,2023-05-17,May,93,3532
32,CodeWithHarry,Animate your Drawings (Killer AI) 🔥,94394,9595,89,2023-05-15,May,35,9684
33,CodeWithHarry,J.A.R.V.I.S - OpenAI + Python  Powered AI Desktop Assistant that Talks Like a Human (FROM SCRATCH!),227508,8429,799,2023-05-14,May,99,9228
34,CodeWithHarry,Web Scraping Tutorial Using Python | BeautifulSoup Tutorial 🔥,41125,1211,200,2023-05-12,May,61,1411
35,CodeWithHarry,MongoDB Tutorial in 1 Hour (2023) 🍃,124619,3676,405,2023-05-10,May,35,4081
36,CodeWithHarry,I Created this website using Pure Python | Anvil Tutorial 🔥,107300,3761,272,2023-05-09,May,59,4033
37,CodeWithHarry,AI For UpScaling Videos 🔥,90226,8344,92,2023-05-07,May,25,8436
38,CodeWithHarry,How to Deploy a High Traffic Django Application using WSGI,10765,359,110,2023-05-06,May,58,469
39,CodeWithHarry,Lets Build a Todos List App using Next.js 13 🔥,26833,973,163,2023-05-05,May,46,1136
40,CodeWithHarry,Google Says AI is Scary 💻,278554,23112,246,2023-05-04,May,25,23358
41,CodeWithHarry,Get your Laptop Battery Report 💻,105263,12237,102,2023-05-02,May,32,12339
42,CodeWithHarry,Windows PowerShell/Terminal Autocomplete,54351,4777,103,2023-05-01,May,40,4880
43,CodeWithHarry,Using MongoDB with Flask Applications (Efficiently),20335,626,243,2023-04-28,Apr,51,869
44,CodeWithHarry,Backend Average Salary 💰,175420,16419,167,2023-04-27,Apr,24,16586
45,CodeWithHarry,How to use TailwindCSS with Python Flask?,15538,565,145,2023-04-26,Apr,41,710
46,CodeWithHarry,Image Editing Website using Python Flask and OpenCV,27384,1106,179,2023-04-25,Apr,51,1285
47,CodeWithHarry,Salary of a Frontend Developer 💵,249251,23156,310,2023-04-25,Apr,32,23466
48,CodeWithHarry,VS Code Snippets Tutorial 👨‍💻,112996,10737,62,2023-04-21,Apr,29,10799
49,CodeWithHarry,Elon Musk's Interview Question 🏪,422456,30453,198,2023-04-20,Apr,32,30651
50,CodeWithHarry,Password generator in Python!,211206,19705,146,2023-04-15,Apr,29,19851
51,CodeWithHarry,VS Code Mouse Wheel Trick 🔥,112628,10697,125,2023-04-15,Apr,27,10822
52,CodeWithHarry,ChatGPT ❌,151583,12344,220,2023-04-14,Apr,9,12564
53,CodeWithHarry,ChatGPT fooled a human!,656216,47811,481,2023-04-13,Apr,23,48292
54,CodeWithHarry,How to Host Multiple Websites on a $5 Server (Step by Step Guide),35419,1147,330,2023-04-10,Apr,65,1477
55,CodeWithHarry,Learn Web Development Fast!,385988,43268,2108,2023-04-09,Apr,27,45376
56,CodeWithHarry,Exploring Requests Module in Python (Deepdive),25148,920,192,2023-04-08,Apr,46,1112
57,CodeWithHarry,5 Tricks of Google Search,172466,20637,107,2023-04-07,Apr,25,20744
58,CodeWithHarry,Download More Ram 💻,250373,21125,1121,2023-04-06,Apr,19,22246
59,CodeWithHarry,Quick and Easy Guide to Set up Your WordPress Blog in Minutes (Fastest Way),28954,1179,217,2023-04-06,Apr,75,1396
60,CodeWithHarry,ChatGPT is Good for Jobs!,140550,12570,83,2023-04-05,Apr,25,12653
61,CodeWithHarry,Aws Activate for Startups!,66142,5855,36,2023-04-04,Apr,26,5891
62,CodeWithHarry,Fake Windows Update 💻,186663,15213,237,2023-03-30,Mar,21,15450
63,CodeWithHarry,ChatGPT helped me create this KBC Quiz App (Watch me Build it),65726,2200,347,2023-03-29,Mar,62,2547
64,CodeWithHarry,Fastest Way to Learn React in 2023 🔥,257903,22441,1573,2023-03-28,Mar,36,24014
65,CodeWithHarry,"AWS Activate: A Program to Support Startups, Founders, & Entrepreneurs  | Amazon Web Services",23139,935,122,2023-03-28,Mar,93,1057
66,CodeWithHarry,Python Crash Course in Hindi | 5 Python Projects | Complete Python Tutorial,400030,14077,1533,2023-03-25,Mar,75,15610
67,CodeWithHarry,Python vs JavaScript: Which one to Learn in 2023? (For Jobs),335572,13303,914,2023-03-18,Mar,60,14217
68,CodeWithHarry,"Choosing the Right Python Web Framework: Django, Flask, or FastAPI?",76074,2582,316,2023-03-15,Mar,67,2898
69,CodeWithHarry,What is a Graph Database? | Getting Started with Neo4j AuraDB: A Step-by-Step Tutorial 🔥,22443,991,162,2023-03-14,Mar,88,1153
70,CodeWithHarry,Free Office 365 on your Own Server (NextCloud Tutorial),24610,984,117,2023-03-13,Mar,55,1101
71,CodeWithHarry,Stop Saving Your Passwords like this (Use Passky Instead!),25069,1204,168,2023-03-12,Mar,58,1372
72,CodeWithHarry,Install VS Code/FireFox like Apps on Ubuntu Server (Get 1GBPS Internet Speed for Free),31029,1064,160,2023-03-11,Mar,86,1224
73,CodeWithHarry,I Created Discord like Calling App in 5 Minutes... (With Custom Domain),33748,1395,146,2023-03-10,Mar,71,1541
74,CodeWithHarry,Docker Made Easy: Discover the Magic of Yacht,21511,806,182,2023-03-08,Mar,45,988
75,CodeWithHarry,Conclusion and Where to go from here | Python Tutorial - Day #100,99287,4784,737,2023-03-07,Mar,65,5521
76,CodeWithHarry,Exercise 11: Solution + Shoutouts - Desktop Notification System | Python Tutorial - Day #99,29495,770,195,2023-03-06,Mar,91,965
77,CodeWithHarry,MultiProcessing in Python | Python Tutorial - Day #98,28448,925,110,2023-03-05,Mar,53,1035
78,CodeWithHarry,Multithreading in Python | Python Tutorial - Day #97,31215,1066,112,2023-03-04,Mar,52,1178
79,CodeWithHarry,AsyncIO in Python | Python Tutorial - Day #96,24952,873,137,2023-03-03,Mar,45,1010
80,CodeWithHarry,Regular Expressions in Python | Python Tutorial - Day #95,31638,1012,100,2023-03-02,Mar,57,1112
81,CodeWithHarry,Exercise 11 - Drink Water Reminder | Python Tutorial - Day #94,19815,697,201,2023-03-01,Mar,62,898
82,CodeWithHarry,Exercise 10 - News App Solution & Shoutout | Python Tutorial - Day #93,20450,738,106,2023-02-28,Feb,70,844
83,CodeWithHarry,SearX: The Private Search Engine You Need to Know About!,79647,3251,369,2023-02-28,Feb,56,3620
84,CodeWithHarry,Function Caching in Python | Python Tutorial - Day #92,18489,856,100,2023-02-27,Feb,54,956
85,CodeWithHarry,Generators in Python | Python Tutorial - Day #91,23786,976,90,2023-02-26,Feb,48,1066
86,CodeWithHarry,I Can Speak Like Shah Rukh Khan - Thanks to this AI 🔥,395194,16008,1851,2023-02-26,Feb,53,17859
87,CodeWithHarry,Exercise 10: News App in Python | Python Tutorial - Day #90,20358,786,90,2023-02-25,Feb,59,876
88,CodeWithHarry,Requests Module in Python | Python Tutorial - Day #89,21600,847,135,2023-02-24,Feb,53,982
89,CodeWithHarry,Exercise 9: Solution - Shoutouts to Everyone | Python Tutorial - Day #88,15679,617,142,2023-02-23,Feb,72,759
90,CodeWithHarry,Shutil Module in Python | Python Tutorial - Day #87,20744,1009,166,2023-02-22,Feb,51,1175
91,CodeWithHarry,Walrus Operator in Python | Python Tutorial - Day #86,20505,899,86,2023-02-21,Feb,53,985
92,CodeWithHarry,Look like a hacker (With this Trick) 🔥🔥,886445,79854,350,2023-02-21,Feb,39,80204
93,CodeWithHarry,Creating command line utility in python | Python Tutorial - Day #85,22877,911,149,2023-02-20,Feb,67,1060
94,CodeWithHarry,Time Module in Python | Python Tutorial - Day #84,23738,1037,536,2023-02-19,Feb,49,1573
95,CodeWithHarry,[Scary] ChatGPT generated this website for me (I am scared) 😢😭,824353,20442,1014,2023-02-19,Feb,62,21456
96,CodeWithHarry,Exercise 9 - Shoutouts to Everyone | Python Tutorial - Day #83,16084,685,99,2023-02-18,Feb,62,784
97,CodeWithHarry,OpenAI Secret Trick - Automated ChatGPT 🔥🔥,651939,51777,223,2023-02-18,Feb,42,52000
98,CodeWithHarry,Exercise 8 - Merge the Pdf Solution in Python | Python Tutorial - Day #82,18714,740,81,2023-02-17,Feb,73,821
99,CodeWithHarry,AWS Innovate Online Conference 🔥,18331,1020,122,2023-02-17,Feb,32,1142
100,CodeWithHarry,Hybrid and Hierarchical Inheritance in Python | Python Tutorial - Day #81,20292,877,89,2023-02-16,Feb,73,966
101,CodeWithHarry,Multilevel Inheritance in Python | Python Tutorial - Day #80,21632,925,139,2023-02-15,Feb,60,1064
102,CodeWithHarry,Multiple Inheritance in Python | Python Tutorial - Day #79,22444,941,90,2023-02-14,Feb,58,1031
103,CodeWithHarry,Single Inheritance in Python | Python Tutorial - Day #78,23209,949,109,2023-02-13,Feb,56,1058
104,CodeWithHarry,Enhance your app's security with this tool 🔥,90569,9290,59,2023-02-12,Feb,44,9349
105,CodeWithHarry,Operator Overloading in Python | Python Tutorial - Day #77,27315,1045,107,2023-02-12,Feb,58,1152
106,CodeWithHarry,Exercise 8 - Merge the PDF | Python Tutorial - Day #76,22138,859,123,2023-02-11,Feb,54,982
107,CodeWithHarry,Exercise 7 Solution + Shoutouts | Python Tutorial - Day #75,20599,795,86,2023-02-10,Feb,59,881
108,CodeWithHarry,Method Overriding in Python | Python Tutorial - Day #74,26815,1022,98,2023-02-09,Feb,55,1120
109,CodeWithHarry,"Spot the bug, I challenge you! 👨‍💻",22009,1399,152,2023-02-09,Feb,34,1551
110,CodeWithHarry,Magic/Dunder Methods in Python | Python Tutorial - Day #73,28430,1178,119,2023-02-08,Feb,58,1297
111,CodeWithHarry,super keyword in Python | Python Tutorial - Day #72,28560,1218,126,2023-02-07,Feb,51,1344
112,CodeWithHarry,"dir, __dict__ and help method in Python | Python Tutorial - Day #71",25856,1181,96,2023-02-06,Feb,67,1277
113,CodeWithHarry,Class Methods as Alternative Constructors in Python | Python Tutorial - Day #70,29257,1162,214,2023-02-05,Feb,79,1376
114,CodeWithHarry,Class Methods in Python | Python Tutorial - Day #69,33761,1253,129,2023-02-04,Feb,51,1382
115,CodeWithHarry,"Lets Build a News App Using ExpressJs +HTML, CSS and JavaScript (Awesome Project) 🔥",65365,2403,198,2023-02-04,Feb,83,2601
116,CodeWithHarry,Exercise 7 - Clear the Clutter | Python Tutorial - Day #68,23014,902,112,2023-02-03,Feb,58,1014
117,CodeWithHarry,Appwrite - An Easy to setup Open-Source Backend Server 🔥,57115,2007,128,2023-02-03,Feb,56,2135
118,CodeWithHarry,Exercise 6 Solution - Library Management Software in Python | Python Tutorial - Day #67,26476,908,138,2023-02-02,Feb,87,1046
119,CodeWithHarry,Instance variables vs Class variables in Python | Python Tutorial - Day #66,32239,1371,114,2023-02-01,Feb,75,1485
120,CodeWithHarry,Static Methods in Python | Python Tutorial - Day #65,37339,1480,273,2023-01-31,Jan,52,1753
121,CodeWithHarry,Exercise 6 - Library Management System in Python | Python Tutorial - Day #64,31213,1195,129,2023-01-30,Jan,76,1324
122,CodeWithHarry,Snake Water Gun Game in Python - Exercise 5 - Solution | Python Tutorial - Day #63,37376,1270,152,2023-01-29,Jan,82,1422
123,CodeWithHarry,Access Modifiers in Python | Python Tutorial - Day #62,41694,1636,139,2023-01-28,Jan,54,1775
124,CodeWithHarry,Inheritance in Python | Python Tutorial - Day #61,50203,1858,134,2023-01-27,Jan,49,1992
125,CodeWithHarry,Learn to Install and Manage Applications on Cloudron | Cloudron Tutorial,11751,513,57,2023-01-27,Jan,72,570
126,CodeWithHarry,Getters and Setters in Python | Python Tutorial - Day #60,52148,1738,189,2023-01-26,Jan,57,1927
127,CodeWithHarry,Decorators in Python | Python Tutorial - Day #59,70390,2484,190,2023-01-25,Jan,48,2674
128,CodeWithHarry,Constructors in Python | Python Tutorial - Day #58,68227,2375,205,2023-01-24,Jan,50,2580
129,CodeWithHarry,Classes and Objects in Python | Python Tutorial - Day #57,92118,3148,578,2023-01-23,Jan,57,3726
130,CodeWithHarry,Introduction to OOPs in Python | Python Tutorial - Day #56,88199,3051,234,2023-01-22,Jan,58,3285
131,CodeWithHarry,Exercise 5 - Snake Water Gun | Python Tutorial - Day #55,39107,1440,251,2023-01-21,Jan,56,1691
132,CodeWithHarry,'is' vs '==' in Python | Python Tutorial - Day #54,37931,1895,210,2023-01-20,Jan,50,2105
133,CodeWithHarry,Tatum: An Amazing platform for Web 3 developers,35960,1610,167,2023-01-20,Jan,47,1777
134,CodeWithHarry,"Map, Filter and Reduce in Python | Python Tutorial - Day #53",55941,2395,523,2023-01-19,Jan,60,2918
135,CodeWithHarry,Lambda functions in Python | Python Tutorial - Day #52,61235,2421,191,2023-01-18,Jan,54,2612
136,CodeWithHarry,"seek(), tell() and other functions | Python Tutorial - Day #51",47134,2115,182,2023-01-17,Jan,62,2297
137,CodeWithHarry,Tips to get Foreign Internship - Part 2,104732,10833,77,2023-01-17,Jan,39,10910
138,CodeWithHarry,"read(), readlines() and other methods | Python Tutorial - Day #50",57618,2195,382,2023-01-16,Jan,65,2577
139,CodeWithHarry,Tips to get Foreign Internship - Part 1,130090,14103,104,2023-01-16,Jan,39,14207
140,CodeWithHarry,File IO in Python | Python Tutorial - Day #49,75588,2701,198,2023-01-15,Jan,45,2899
141,CodeWithHarry,Local vs Global Variables in Python| Python Tutorial - Day #48,53220,2346,235,2023-01-14,Jan,62,2581
142,CodeWithHarry,PC and App Streaming on the Browser: Kasm Workspaces,17321,823,105,2023-01-14,Jan,52,928
143,CodeWithHarry,Exercise 4: Solutions and Shoutouts | Python Tutorial - Day #47,45984,1565,192,2023-01-13,Jan,63,1757
144,CodeWithHarry,os Module in Python | Python Tutorial - Day #46,69015,2664,238,2023-01-12,Jan,47,2902
145,CodeWithHarry,"if __name__ == ""__main__"" in Python | Python Tutorial - Day #45",65010,2834,287,2023-01-11,Jan,63,3121
146,CodeWithHarry,How import works in Python | Python Tutorial - Day #44,59962,2527,216,2023-01-10,Jan,54,2743
147,CodeWithHarry,Can ChatGPT solve JEE Advanced Problem?,309376,10767,788,2023-01-10,Jan,39,11555
148,CodeWithHarry,*One* tip to learn programming fast,382932,46709,340,2023-01-10,Jan,35,47049
149,CodeWithHarry,Virtual Environment in Python | Python Tutorial - Day #43,72533,2742,285,2023-01-09,Jan,57,3027
150,CodeWithHarry,I asked ChatGPT to write me a standup comedy script!,112153,4772,296,2023-01-09,Jan,52,5068
151,CodeWithHarry,Avoid this mistake as a coder!,197547,24439,104,2023-01-09,Jan,30,24543
152,CodeWithHarry,Enumerate Function in Python | Python Tutorial - Day #42,62791,2494,183,2023-01-08,Jan,56,2677
153,CodeWithHarry,Short hand if else statements | Python Tutorial - Day #41,59101,2621,339,2023-01-07,Jan,57,2960
154,CodeWithHarry,Which programming language to learn first?🔥,203146,19775,182,2023-01-07,Jan,43,19957
155,CodeWithHarry,Exercise 4: Secret Code Language | Python Tutorial - Day #40,61346,2313,422,2023-01-06,Jan,60,2735
156,CodeWithHarry,5 ways to make money as a programmer 🤑,235911,30666,94,2023-01-06,Jan,38,30760
157,CodeWithHarry,Kaun Banega Crorepati: Exercise 3 - Solution & Shoutouts | Python Tutorial - Day #39,80974,2597,356,2023-01-05,Jan,84,2953
158,CodeWithHarry,One Harsh truth about programming ☹️,217927,26777,199,2023-01-05,Jan,36,26976
159,CodeWithHarry,Raising custom errors in Python | Python Tutorial - Day #38,72356,3084,452,2023-01-04,Jan,59,3536
160,CodeWithHarry,5 ways to master programming logic 🔥,284990,44445,108,2023-01-04,Jan,36,44553
161,CodeWithHarry,Finally keyword in Python | Python Tutorial - Day #37,71957,3183,255,2023-01-03,Jan,53,3438
162,CodeWithHarry,5 Tips for Maximum Package College Placement,209179,25291,90,2023-01-03,Jan,44,25381
163,CodeWithHarry,Exception Handling in Python | Python Tutorial - Day #36,101922,3713,278,2023-01-02,Jan,56,3991
164,CodeWithHarry,I Interviewed ChatGPT 🔥,692926,44299,668,2023-01-01,Jan,23,44967
165,CodeWithHarry,ChatGPT will replace you....,511107,21616,1461,2023-01-01,Jan,28,23077
166,CodeWithHarry,for Loop with else in Python | Python Tutorial - Day #35,65688,3125,345,2023-01-01,Jan,56,3470
167,CodeWithHarry,Make more money with these 5 Non Tech Skills💰💰,106719,13404,66,2023-01-01,Jan,46,13470
168,CodeWithHarry,Dictionary Methods in Python | Python Tutorial - Day #34,70436,2996,300,2022-12-31,Dec,56,3296
169,CodeWithHarry,5 tips to beat procrastination 🔥,68869,7988,61,2022-12-31,Dec,32,8049
170,CodeWithHarry,Dictionaries in Python | Python Tutorial - Day #33,95837,3663,377,2022-12-30,Dec,50,4040
171,CodeWithHarry,Set Methods in Python | Python Tutorial - Day #32,88324,3303,282,2022-12-29,Dec,49,3585
172,CodeWithHarry,I Created a Programming Rap Song with ChatGPT 🧑‍🎤,474068,14226,814,2022-12-29,Dec,49,15040
173,CodeWithHarry,Sets in Python | Python Tutorial - Day #31,88542,3441,330,2022-12-28,Dec,42,3771
174,CodeWithHarry,Man Sued his own company 🤣😆😅,273637,19993,326,2022-12-28,Dec,28,20319
175,CodeWithHarry,Recursion in Python | Python Tutorial - Day #30,114167,3871,529,2022-12-27,Dec,47,4400
176,CodeWithHarry,Docstrings in Python | Python Tutorial - Day #29,90546,3502,281,2022-12-26,Dec,48,3783
177,CodeWithHarry,Whatsapp Data Breach  👨‍💻,84248,6175,151,2022-12-26,Dec,25,6326
178,CodeWithHarry,f-strings in Python | Python Tutorial - Day #28,103741,3816,336,2022-12-25,Dec,47,4152
179,CodeWithHarry,5 ways to make money in Cybersecurity!,273999,26108,129,2022-12-25,Dec,38,26237
180,CodeWithHarry,Exercise 3: Kaun Banega Crorepati (KBC) | Python Tutorial - Day #27,89008,2992,548,2022-12-24,Dec,67,3540
181,CodeWithHarry,The best Todo App (**Ever**) 📝,88982,9116,158,2022-12-24,Dec,30,9274
182,CodeWithHarry,Exercise 2: Solution & Shoutouts | Python Tutorial - Day #26,86179,2669,259,2022-12-23,Dec,60,2928
183,CodeWithHarry,Operations on Tuples in Python | Python Tutorial - Day #25,96784,3710,268,2022-12-22,Dec,58,3978
184,CodeWithHarry,Tuples in Python | Python Tutorial - Day #24,111083,4306,333,2022-12-21,Dec,44,4639
185,CodeWithHarry,List Methods in Python | Python Tutorial - Day #23,116549,4552,448,2022-12-20,Dec,50,5000
186,CodeWithHarry,Introduction to Lists in Python | Python Tutorial - Day #22,151520,5297,852,2022-12-19,Dec,59,6149
187,CodeWithHarry,Function Arguments in Python | Python Tutorial - Day #21,166278,5462,532,2022-12-18,Dec,56,5994
188,CodeWithHarry,Functions in Python | Python Tutorial - Day #20,212954,6905,739,2022-12-17,Dec,47,7644
189,CodeWithHarry,break and continue in Python | Python Tutorial - Day #19,157417,5456,619,2022-12-16,Dec,56,6075
190,CodeWithHarry,While Loops in Python | Python Tutorial - Day #18,183706,5935,515,2022-12-15,Dec,49,6450
191,CodeWithHarry,For Loops in Python | Python Tutorial - Day #17,216348,6966,647,2022-12-14,Dec,47,7613
192,CodeWithHarry,Match Case Statements in Python | Python Tutorial - Day #16,188808,5803,614,2022-12-13,Dec,59,6417
193,CodeWithHarry,Exercise 2: Good Morning Sir | Python Tutorial - Day #15,191425,5176,1020,2022-12-12,Dec,56,6196
194,CodeWithHarry,If Else Conditional Statements in Python | Python Tutorial - Day #14,247209,7329,832,2022-12-11,Dec,68,8161
195,CodeWithHarry,₹ 936 crores fine to Google again💰,221388,17963,198,2022-12-11,Dec,34,18161
196,CodeWithHarry,String Methods in Python | Python Tutorial - Day #13,297778,9769,751,2022-12-10,Dec,52,10520
197,CodeWithHarry,Money Making Opportunity 🔥,421941,60190,443,2022-12-10,Dec,26,60633
198,CodeWithHarry,Strings Slicing and Operations on Strings in Python | Python Tutorial - Day #12,250954,8249,1142,2022-12-09,Dec,79,9391
199,CodeWithHarry,Create your own VPN server using Open VPN,114991,4297,203,2022-12-09,Dec,41,4500
200,CodeWithHarry,Strings in Python | Python Tutorial - Day #11,276539,9364,818,2022-12-08,Dec,45,10182
201,CodeWithHarry,Taking User Input in Python | Python Tutorial - Day #10,257860,10402,1075,2022-12-07,Dec,55,11477
202,CodeWithHarry,Typecasting in Python | Python Tutorial - Day #9,281155,10562,1002,2022-12-06,Dec,48,11564
203,CodeWithHarry,"Creating a Weather App Using HTML, CSS and JavaScript 🔥",360253,9882,667,2022-12-06,Dec,55,10549
204,CodeWithHarry,Exercise 1: Calculator using Python (Solution) | Python Tutorial - Day #8,278673,8555,886,2022-12-05,Dec,73,9441
205,CodeWithHarry,Exercise 1: Calculator using Python | Python Tutorial - Day #7,313529,9550,1479,2022-12-04,Dec,62,11029
206,CodeWithHarry,"Creating a Dictionary App using HTML, CSS, JavaScript & RapidAPI",69441,2274,175,2022-12-04,Dec,64,2449
207,CodeWithHarry,Variables and Data Types | Python Tutorial - Day #6,414303,14806,1673,2022-12-03,Dec,51,16479
208,CodeWithHarry,Create your own Social Media Website - Mastodon Server Tutorial 🔥,42768,2137,212,2022-12-03,Dec,65,2349
209,CodeWithHarry,My Favorite VS Code Extension 🔥,228483,21906,74,2022-12-03,Dec,31,21980
210,CodeWithHarry,"Comments, Escape Sequences & Print Statement | Python Tutorial - Day #5",489000,15478,2619,2022-12-02,Dec,71,18097
211,CodeWithHarry,Recession and layoffs - When will it end?,279728,13806,579,2022-12-02,Dec,41,14385
212,CodeWithHarry,Our First Python Program | Python Tutorial - Day #4,471390,16383,3702,2022-12-01,Dec,51,20085
213,CodeWithHarry,Modules and Pip | Python Tutorial - Day #3,650966,20165,1503,2022-11-30,Nov,42,21668
214,CodeWithHarry,Some Amazing Python Programs - The Power of Python | Python Tutorial - Day #2,745249,27060,1853,2022-11-29,Nov,77,28913
215,CodeWithHarry,Introduction to Programming & Python | Python Tutorial - Day #1,2093880,74696,12993,2022-11-28,Nov,63,87689
216,CodeWithHarry,#100DaysOfCode with Python,178596,29854,6181,2022-11-27,Nov,26,36035
217,CodeWithHarry,Upskill on cloud : A guided tutorial to avail 50% discount on certification,20184,1121,116,2022-11-27,Nov,75,1237
218,CodeWithHarry,"Lets Create a World Clock with Alarm Using HTML, CSS & JavaScript",64911,2428,239,2022-11-26,Nov,65,2667
219,CodeWithHarry,AI for Frontend Development 🔥,159166,18659,150,2022-11-25,Nov,29,18809
220,CodeWithHarry,THIS NEEDS TO STOP! Shame! (Watch full video) 😢,392189,23785,1462,2022-11-22,Nov,47,25247
221,CodeWithHarry,3 Killer Job Tips 🔥,137473,14588,111,2022-11-20,Nov,19,14699
222,CodeWithHarry,(∄ a) A Perfect Developer 💻,275538,38810,220,2022-11-18,Nov,27,39030
223,CodeWithHarry,Locofy.ai: Convert your Figma designs to Quality Code 🔥,189264,6405,359,2022-11-17,Nov,55,6764
224,CodeWithHarry,Project 2: Bulk Rename Desktop App in Node.js | JavaScript Tutorial in Hindi #103,71549,1613,276,2022-11-15,Nov,81,1889
225,CodeWithHarry,Project 1: PDF Merger WebApp Using JavaScript & Bootstrap | JavaScript Tutorial in Hindi #102,140246,3369,419,2022-11-10,Nov,93,3788
226,CodeWithHarry,Exercise 8 - Solutions and Shoutouts | JavaScript Tutorial in Hindi #101,36591,782,81,2022-11-10,Nov,72,863
227,CodeWithHarry,Event Loop in JavaScript | JavaScript Tutorial in Hindi #100,60099,1994,276,2022-11-09,Nov,60,2270
228,CodeWithHarry,Regular Expressions in JavaScript | JavaScript Tutorial in Hindi #99,50207,1404,74,2022-11-08,Nov,68,1478
229,CodeWithHarry,Top 3 Languages for Web Development,417354,40136,193,2022-11-07,Nov,35,40329
230,CodeWithHarry,Top 3 Programming Languages 💻,706171,72795,318,2022-11-06,Nov,29,73113
231,CodeWithHarry,Using Express.js to Create a Backend Server | JavaScript Tutorial in Hindi #98,32762,1125,150,2022-11-05,Nov,78,1275
232,CodeWithHarry,Modules in JavaScript | JavaScript Tutorial in Hindi #97,36620,1165,93,2022-11-05,Nov,56,1258
233,CodeWithHarry,Is Maths required for coding?,474952,49806,231,2022-11-04,Nov,29,50037
234,CodeWithHarry,npm and Node.js Packages | JavaScript Tutorial in Hindi #96,41369,1298,162,2022-11-04,Nov,59,1460
235,CodeWithHarry,3 GBPS = Your Internet Speed 🤯,514786,54579,337,2022-11-03,Nov,30,54916
236,CodeWithHarry,JavaScript on the Server | JavaScript Tutorial in Hindi #95,30507,1170,80,2022-11-03,Nov,59,1250
237,CodeWithHarry,Exercise 8 - Alarm Clock | JavaScript Tutorial in Hindi #94,23319,784,54,2022-11-03,Nov,59,838
238,CodeWithHarry,Best Coding App for Phones🔥,363864,35233,284,2022-11-02,Nov,27,35517
239,CodeWithHarry,Exercise 7 - Password Generator Solution | JavaScript Tutorial in Hindi #93,28031,947,67,2022-11-02,Nov,75,1014
240,CodeWithHarry,JavaScript Chapter 12 - Practice Set | JavaScript Tutorial in Hindi #92,21189,854,73,2022-11-02,Nov,71,927
241,CodeWithHarry,Match Case 🐍,56884,5486,51,2022-11-02,Nov,12,5537
242,CodeWithHarry,Arrow Functions Revisited | JavaScript Tutorial in Hindi #91,48942,1622,118,2022-10-31,Oct,60,1740
243,CodeWithHarry,Closures in JavaScript | JavaScript Tutorial in Hindi #90,63063,2072,124,2022-10-31,Oct,57,2196
244,CodeWithHarry,Hoisting in JavaScript | JavaScript Tutorial in Hindi #89,61266,2005,164,2022-10-28,Oct,57,2169
245,CodeWithHarry,local and global Scope in JavaScript | JavaScript Tutorial in Hindi #88,32901,1252,63,2022-10-28,Oct,71,1315
246,CodeWithHarry,Destructuring assignment and Spread Operator | JavaScript Tutorial in Hindi #87,44133,1631,84,2022-10-28,Oct,79,1715
247,CodeWithHarry,IIFE - Immediately Invoked Function Expressions | JavaScript Tutorial in Hindi #86,37600,1403,138,2022-10-27,Oct,82,1541
248,CodeWithHarry,Monitor your Server from Browser like a Pro - CasaOS 🔥,27211,1099,107,2022-10-26,Oct,54,1206
249,CodeWithHarry,Exercise 7 - Password Generator | JavaScript Tutorial in Hindi #85,31089,1037,88,2022-10-25,Oct,66,1125
250,CodeWithHarry,Google's business strategy! (brilliant) 🔥,123406,8482,46,2022-10-24,Oct,41,8528
251,CodeWithHarry,Exercise 6 - Solution & Shoutouts | JavaScript Tutorial in Hindi #84,32321,944,146,2022-10-23,Oct,68,1090
252,CodeWithHarry,JavaScript Chapter 11 Practice Set | JavaScript Tutorial in Hindi #83,25537,1066,92,2022-10-23,Oct,69,1158
253,CodeWithHarry,Windows 12 leaked (Have a Look)😯,343850,20964,188,2022-10-22,Oct,32,21152
254,CodeWithHarry,"getters, setters & instanceOf Operator | JavaScript Tutorial in Hindi #82",39219,1561,157,2022-10-22,Oct,73,1718
255,CodeWithHarry,"₹1,337.76 crore fine on Google",141976,10379,144,2022-10-21,Oct,30,10523
256,CodeWithHarry,$19M fine on Apple 🍎,129254,10508,126,2022-10-21,Oct,20,10634
257,CodeWithHarry,Static Method in JavaScript | JavaScript Tutorial in Hindi #81,34482,1191,64,2022-10-21,Oct,62,1255
258,CodeWithHarry,Constructors in JavaScript | JavaScript Tutorial in Hindi #80,33787,1363,239,2022-10-20,Oct,61,1602
259,CodeWithHarry,Constructors in JavaScript | JavaScript Tutorial in Hindi #79,35115,1324,98,2022-10-20,Oct,61,1422
260,CodeWithHarry,Constructors in JavaScript | JavaScript Tutorial in Hindi #77,53010,1589,61,2022-10-20,Oct,61,1650
261,CodeWithHarry,Inheritance & extends Keyword in JavaScript | JavaScript Tutorial in Hindi #78,40271,1603,114,2022-10-20,Oct,78,1717
262,CodeWithHarry,WhatsApp Vulnerability 👩‍💻👨‍💻,262017,16449,130,2022-10-19,Oct,29,16579
263,CodeWithHarry,Classes and Objects in JavaScript | JavaScript Tutorial in Hindi #76,77540,2049,135,2022-10-19,Oct,68,2184
264,CodeWithHarry,Protypes and __proto__ in JavaScript | JavaScript Tutorial in Hindi #75,55313,1670,95,2022-10-19,Oct,71,1765
265,CodeWithHarry,Introduction to Object Oriented Programming | JavaScript Tutorial in Hindi #74,64055,1995,121,2022-10-18,Oct,78,2116
266,CodeWithHarry,This Investment Is Worth It 💰💰,284279,24989,200,2022-10-17,Oct,30,25189
267,CodeWithHarry,Exercise 6: Todo List | JavaScript Tutorial in Hindi #73,39586,971,59,2022-10-17,Oct,56,1030
268,CodeWithHarry,Exercise 5: Solutions & Shoutouts | JavaScript Tutorial in Hindi #72,30274,1007,50,2022-10-17,Oct,68,1057
269,CodeWithHarry,JavaScript Chapter 10 - Practice Set | JavaScript Tutorial in Hindi #71,40659,1411,233,2022-10-16,Oct,71,1644
270,CodeWithHarry,sessionStorage & related methods | JavaScript Tutorial in Hindi #70,39395,1458,81,2022-10-16,Oct,67,1539
271,CodeWithHarry,localStorage & related methods | JavaScript Tutorial in Hindi #69,64364,1975,109,2022-10-15,Oct,65,2084
272,CodeWithHarry,Cookies in JavaScript| JavaScript Tutorial in Hindi #68,68492,2136,106,2022-10-15,Oct,55,2242
273,CodeWithHarry,Sending POST request with Fetch API | JavaScript Tutorial in Hindi #67,77874,1935,323,2022-10-14,Oct,70,2258
274,CodeWithHarry,Fetch API | JavaScript Tutorial in Hindi #66,141822,3313,122,2022-10-14,Oct,44,3435
275,CodeWithHarry,Every Freelancer should do *these* (Max Earnings),134606,7269,269,2022-10-13,Oct,49,7538
276,CodeWithHarry,Exercise 5: Hackerman | JavaScript Tutorial in Hindi #65,36281,1339,117,2022-10-13,Oct,56,1456
277,CodeWithHarry,Exercise 4: Solutions & Shoutouts | JavaScript Tutorial in Hindi #64,38235,1199,80,2022-10-12,Oct,68,1279
278,CodeWithHarry,JavaScript Chapter 9 - Practice Set  | JavaScript Tutorial in Hindi #63,46136,1584,107,2022-10-12,Oct,71,1691
279,CodeWithHarry,The Finally Clause | JavaScript Tutorial in Hindi #62,43801,1964,246,2022-10-11,Oct,53,2210
280,CodeWithHarry,The Error Object & Custom Errors | JavaScript Tutorial in Hindi #61,50049,1828,96,2022-10-10,Oct,67,1924
281,CodeWithHarry,Data Breach 🤯,83391,5185,54,2022-10-10,Oct,13,5239
282,CodeWithHarry,Free AI Code Completion 🔥,132664,10702,53,2022-10-10,Oct,25,10755
283,CodeWithHarry,Error Handling: try and catch | JavaScript Tutorial in Hindi #60,68371,2400,175,2022-10-09,Oct,64,2575
284,CodeWithHarry,Sova Virus is Dangerous! 👨‍💻,155656,11468,103,2022-10-08,Oct,28,11571
285,CodeWithHarry,Async/Await in JavaScript | JavaScript Tutorial in Hindi #59,133082,3657,207,2022-10-08,Oct,60,3864
286,CodeWithHarry,Use Your Computer From a Browser Tab (Amazing Technology),125587,4166,322,2022-10-07,Oct,57,4488
287,CodeWithHarry,The Promise API | JavaScript Tutorial in Hindi #58,67661,2353,144,2022-10-07,Oct,50,2497
288,CodeWithHarry,Attaching Multiple Handlers to a Promise | JavaScript Tutorial in Hindi #57,57435,1954,112,2022-10-06,Oct,75,2066
289,CodeWithHarry,Promise Chaining .then() calls | JavaScript Tutorial in Hindi #56,82031,2391,146,2022-10-06,Oct,65,2537
290,CodeWithHarry,Promise .then() and .catch() | JavaScript Tutorial in Hindi #55,111063,3269,160,2022-10-05,Oct,63,3429
291,CodeWithHarry,Awesome .new Domains 🔥,78141,8282,59,2022-10-05,Oct,22,8341
292,CodeWithHarry,"₹8,00,000 from GTA 5 🤯",387647,32374,136,2022-10-04,Oct,22,32510
293,CodeWithHarry,Introduction to Promises | JavaScript Tutorial in Hindi #54,142338,3784,207,2022-10-04,Oct,59,3991
294,CodeWithHarry,Callback Hell & Pyramid of Doom | JavaScript Tutorial in Hindi #53,84283,2677,186,2022-10-02,Oct,66,2863
295,CodeWithHarry,Python Heart 💘,207745,18845,147,2022-10-02,Oct,14,18992
296,CodeWithHarry,Introduction to Callbacks | JavaScript Tutorial in Hindi #52,153402,3915,394,2022-10-01,Oct,60,4309
297,CodeWithHarry,How to Create a Beautiful Website in 5 - 10 Minutes 🔥,55788,2368,262,2022-09-28,Sep,53,2630
298,CodeWithHarry,Coding AI for Phones 📳,122257,12789,136,2022-09-27,Sep,22,12925
299,CodeWithHarry,Which Monitor to buy in 2022? (Shortlisted Models),23177,686,171,2022-09-25,Sep,50,857
300,CodeWithHarry,"20K, 30K and 50K PC Builds for Coders (2022 Edition) 🔥",59983,2398,219,2022-09-25,Sep,54,2617
301,CodeWithHarry,How much primary storage SSD do you need?,104948,4236,412,2022-09-25,Sep,41,4648
302,CodeWithHarry,Which Apple MacBook to Buy? (No Mistakes) 💻,154641,4118,460,2022-09-25,Sep,43,4578
303,CodeWithHarry,Dont Buy these Laptops 🚫,316108,12267,1064,2022-09-24,Sep,24,13331
304,CodeWithHarry,PC Build Or Low Budget Laptop (Final Verdict),57383,3007,363,2022-09-23,Sep,45,3370
305,CodeWithHarry,Tricks to Search for good Laptop Models Yourself (Tutorial),212944,8123,631,2022-09-23,Sep,59,8754
306,CodeWithHarry,Shortcuts 99.9% coders don't know about!,228449,20946,97,2022-09-21,Sep,40,21043
307,CodeWithHarry,Exercise 4: Clock using JavaScript | JavaScript Tutorial in Hindi #51,71367,2013,230,2022-09-21,Sep,69,2243
308,CodeWithHarry,This Tailwind CSS Website is Amazing 🔥,121767,11964,54,2022-09-20,Sep,38,12018
309,CodeWithHarry,Exercise 3: Solution & Shoutouts | JavaScript Tutorial in Hindi #50,58013,1648,140,2022-09-20,Sep,67,1788
310,CodeWithHarry,₹20000000 from Google! 🤯,1323725,98892,1710,2022-09-19,Sep,24,100602
311,CodeWithHarry,JavaScript Chapter 8 - Practice Set | JavaScript Tutorial in Hindi #49,65650,2191,170,2022-09-19,Sep,70,2361
312,CodeWithHarry,This needs to be said!,87026,9021,69,2022-09-18,Sep,22,9090
313,CodeWithHarry,Handling Browser Events | JavaScript Tutorial in Hindi #48,92261,3263,272,2022-09-17,Sep,58,3535
314,CodeWithHarry,Introduction to Browser Events | JavaScript Tutorial in Hindi #47,80756,2764,222,2022-09-16,Sep,65,2986
315,CodeWithHarry,setInterval and setTimeout in JavaScript | JavaScript Tutorial in Hindi #46,87224,2938,196,2022-09-15,Sep,75,3134
316,CodeWithHarry,Changing HTML Classes using JavaScript: className and classList | JavaScript Tutorial in Hindi #45,74623,2712,135,2022-09-15,Sep,98,2847
317,CodeWithHarry,"insertAdjacentHTML, insertAdjacentElement and insertAdjacentText  | JavaScript Tutorial in Hindi #44",66122,2473,168,2022-09-15,Sep,100,2641
318,CodeWithHarry,Instagram Account Hacked?,431586,26150,396,2022-09-14,Sep,25,26546
319,CodeWithHarry,HTML Insertion Methods | JavaScript Tutorial in Hindi #43,85273,2979,221,2022-09-14,Sep,57,3200
320,CodeWithHarry,Build your First Website the Easiest Way using WordPress!,278872,7137,367,2022-09-14,Sep,57,7504
321,CodeWithHarry,HTML Attributes and their methods | JavaScript Tutorial in Hindi #42,90304,3199,176,2022-09-14,Sep,68,3375
322,CodeWithHarry,Gazab ki Google Trick 🔥🔥,201589,18729,184,2022-09-12,Sep,24,18913
323,CodeWithHarry,"innerHTML, outerHTML and other properties | JavaScript Tutorial in Hindi #41",121494,3462,224,2022-09-12,Sep,76,3686
324,CodeWithHarry,620 GBPS ka attack 🤯,164940,17909,135,2022-09-11,Sep,20,18044
325,CodeWithHarry,Stock market fraud 😲,256883,25448,170,2022-09-10,Sep,20,25618
326,CodeWithHarry,Exercise 3 - Tell me a Joke | JavaScript Tutorial in Hindi #40,84360,2343,256,2022-09-10,Sep,62,2599
327,CodeWithHarry,JavaScript Exercise 2: Solution & Shoutouts | JavaScript Tutorial in Hindi #39,84916,2398,185,2022-09-09,Sep,78,2583
328,CodeWithHarry,JavaScript Chapter 7 - Practice Set | JavaScript Tutorial in Hindi #38,84236,3013,374,2022-09-08,Sep,70,3387
329,CodeWithHarry,"matches, closest and contains | JavaScript Tutorial in Hindi #37",101983,3508,361,2022-09-06,Sep,64,3869
330,CodeWithHarry,Searching the DOM | JavaScript Tutorial in Hindi #36,126893,4073,322,2022-09-05,Sep,52,4395
331,CodeWithHarry,Table Navigation | JavaScript Tutorial in Hindi #35,110423,3692,277,2022-09-04,Sep,51,3969
332,CodeWithHarry,Element only Navigation | JavaScript Tutorial in Hindi #34,108313,3452,172,2022-09-04,Sep,58,3624
333,CodeWithHarry,Parents & Siblings of an Element | JavaScript Tutorial in Hindi #33,117975,3749,173,2022-09-03,Sep,67,3922
334,CodeWithHarry,Accessing Children of an Element | JavaScript Tutorial in Hindi #32,129463,3995,289,2022-09-03,Sep,67,4284
335,CodeWithHarry,Signup & use Wordpress on Dreamhost 💻,40101,2247,35,2022-09-02,Sep,37,2282
336,CodeWithHarry,Walking the DOM | JavaScript Tutorial in Hindi #31,159758,4598,233,2022-09-02,Sep,50,4831
337,CodeWithHarry,Possible reasons you are not getting the job you wanted!,64398,3680,321,2022-09-01,Sep,56,4001
338,CodeWithHarry,Khatarnaak Game 🤯😲,588906,42051,225,2022-08-31,Aug,18,42276
339,CodeWithHarry,Personal Portfolio Website + Blog Using WordPress (No Coding),77696,2679,274,2022-08-30,Aug,61,2953
340,CodeWithHarry,"Exercise 2 - Snake, Water and Gun| JavaScript Tutorial in Hindi #30",117426,3228,295,2022-08-29,Aug,67,3523
341,CodeWithHarry,JavaScript Chapter 6 - Practice Set | JavaScript Tutorial in Hindi #29,130779,4092,410,2022-08-28,Aug,70,4502
342,CodeWithHarry,"DOM, BOM & Window Object | JavaScript Tutorial in Hindi #28",184101,5671,262,2022-08-28,Aug,59,5933
343,CodeWithHarry,"JavaScript alert, prompt & confirm | JavaScript Tutorial in Hindi #27",142910,4554,252,2022-08-26,Aug,69,4806
344,CodeWithHarry,Machine Learning use cases you probably don't know about,109873,6592,372,2022-08-25,Aug,56,6964
345,CodeWithHarry,Easy Game Development 🔥,133204,10398,149,2022-08-23,Aug,23,10547
346,CodeWithHarry,JavaScript Exercise 1: Solution & Shoutouts | JavaScript Tutorial in Hindi #26,129790,3715,370,2022-08-21,Aug,78,4085
347,CodeWithHarry,This Happens on Dark Web 🔥,1097034,67557,962,2022-08-20,Aug,26,68519
348,CodeWithHarry,JavaScript Console Object | JavaScript Tutorial in Hindi #25,142635,4629,258,2022-08-19,Aug,60,4887
349,CodeWithHarry,JavaScript Script Tag | JavaScript Tutorial in Hindi #24,138882,4434,230,2022-08-18,Aug,56,4664
350,CodeWithHarry,JavaScript in the Browser | JavaScript Tutorial in Hindi #23,163497,4950,312,2022-08-17,Aug,60,5262
351,CodeWithHarry,SQL Injection 💉,186730,15361,138,2022-08-16,Aug,15,15499
352,CodeWithHarry,Exercise 1 - Guess the Number | JavaScript Tutorial in Hindi #22,160016,4866,602,2022-08-15,Aug,64,5468
353,CodeWithHarry,JavaScript Chapter 5 - Practice Set on Arrays | JavaScript Tutorial in Hindi #21,147086,4845,365,2022-08-14,Aug,80,5210
354,CodeWithHarry,"Map, Filter & Reduce in JavaScript | JavaScript Tutorial in Hindi #20",267914,7523,404,2022-08-13,Aug,69,7927
355,CodeWithHarry,Killer GitHub Readme 🐱‍👤,101081,8480,55,2022-08-12,Aug,24,8535
356,CodeWithHarry,Using Loops With Arrays in JavaScript | JavaScript Tutorial in Hindi #19,206998,6603,384,2022-08-11,Aug,72,6987
357,CodeWithHarry,BOTNET: Are you Hijacked? 🤠,139561,10625,83,2022-08-10,Aug,27,10708
358,CodeWithHarry,Some More JavaScript Array Methods | JavaScript Tutorial in Hindi #18,202951,6867,498,2022-08-09,Aug,69,7365
359,CodeWithHarry,JavaScript Array Methods | JavaScript Tutorial in Hindi #17,212448,6001,336,2022-08-06,Aug,59,6337
360,CodeWithHarry,Introduction to Arrays | JavaScript Tutorial in Hindi #16,224208,6436,659,2022-08-05,Aug,57,7095
361,CodeWithHarry,JavaScript Chapter 4 - Practice Set on Strings | JavaScript Tutorial in Hindi #15,162694,5151,1056,2022-08-04,Aug,81,6207
362,CodeWithHarry,JavaScript String Methods | JavaScript Tutorial in Hindi #14,218042,6647,777,2022-08-03,Aug,60,7424
363,CodeWithHarry,Introduction to Strings | JavaScript Tutorial in Hindi #13,230844,7786,1051,2022-08-02,Aug,58,8837
364,CodeWithHarry,Quick Resume Trick 🔥💵,126493,13019,87,2022-08-02,Aug,21,13106
365,CodeWithHarry,Windows 12,199058,13203,148,2022-08-01,Aug,10,13351
366,CodeWithHarry,JavaScript Chapter 3 - Practice Set on Loops and Functions | JavaScript Tutorial in Hindi #12,219828,6646,571,2022-07-31,Jul,93,7217
367,CodeWithHarry,Functions in JavaScript | JavaScript Tutorial in Hindi #11,321781,8686,471,2022-07-30,Jul,58,9157
368,CodeWithHarry,While Loops in JavaScript | JavaScript Tutorial in Hindi #10,235891,6800,1112,2022-07-29,Jul,60,7912
369,CodeWithHarry,This VS Code Extension will replace Postman 🔥,90229,3288,262,2022-07-29,Jul,45,3550
370,CodeWithHarry,For Loops in JavaScript | JavaScript Tutorial in Hindi #9,384775,9520,854,2022-07-28,Jul,57,10374
371,CodeWithHarry,JavaScript Chapter 2 - Practice Set on Operators and Conditionals | JavaScript Tutorial in Hindi #8,289089,8685,1648,2022-07-27,Jul,99,10333
372,CodeWithHarry,Redis: This can change your Database Game - Here how!,70339,2800,238,2022-07-25,Jul,53,3038
373,CodeWithHarry,Conditional expressions in JavaScript | JavaScript Tutorial in Hindi #7,400921,11459,2480,2022-07-24,Jul,71,13939
374,CodeWithHarry,JavaScript Operators and Expressions | JavaScript Tutorial in Hindi #6,464590,12577,1674,2022-07-23,Jul,70,14251
375,CodeWithHarry,Unboxing a coder’s dream monitor | Mast hai ye 😍😍,296777,9660,665,2022-07-22,Jul,49,10325
376,CodeWithHarry,JavaScript  Chapter 1 - Practice Set | JavaScript Tutorial in Hindi #5,462050,14421,1405,2022-07-20,Jul,70,15826
377,CodeWithHarry,Primitives and Objects in JavaScript | JavaScript Tutorial in Hindi #4,519462,14725,969,2022-07-19,Jul,70,15694
378,CodeWithHarry,"const, let and var in JavaScript | JavaScript Tutorial in Hindi #3",597409,18164,1158,2022-07-17,Jul,66,19322
379,CodeWithHarry,Variables in JavaScript | JavaScript Tutorial in Hindi #2,863608,24502,1855,2022-07-15,Jul,57,26357
380,CodeWithHarry,Introduction to JavaScript + Setup | JavaScript Tutorial in Hindi #1,2220656,59428,6243,2022-07-14,Jul,68,65671
381,CodeWithHarry,Ultimate JavaScript Course - Announcement 🔥,137275,16157,2413,2022-07-13,Jul,43,18570
382,CodeWithHarry,Hate PHP? | Where php Shines 🌟,139819,10808,108,2022-07-12,Jul,30,10916
383,CodeWithHarry,An Innovative way used by Hackers!,1490271,123104,1000,2022-07-06,Jul,34,124104
384,CodeWithHarry,Unix & C,77998,5100,155,2022-07-02,Jul,8,5255
385,CodeWithHarry,Should you use a secondary editor?,34292,1439,207,2022-06-30,Jun,34,1646
386,CodeWithHarry,I almost got Hacked! 🐱‍💻😲,1647854,129638,973,2022-06-30,Jun,25,130611
387,CodeWithHarry,Finding Best Selling Products Using Public User Reviews & BrightData,27775,1253,142,2022-06-29,Jun,68,1395
388,CodeWithHarry,Time Saving Microsoft Edge Feature 🔥,181636,13938,131,2022-06-28,Jun,36,14069
389,CodeWithHarry,4 Amazing Facts About Steve Jobs,114225,10314,106,2022-06-27,Jun,32,10420
390,CodeWithHarry,Displaying All products in a Material UI Table | NextJs Tutorial for Beginners #79,26387,542,128,2022-06-26,Jun,82,670
391,CodeWithHarry,Github Copilot ka Dhoka 😅,77841,4250,98,2022-06-25,Jun,25,4348
392,CodeWithHarry,Creating a Form for Adding Product | NextJs Tutorial for Beginners #78,13095,342,84,2022-06-25,Jun,70,426
393,CodeWithHarry,Populating pages with pages from the template| NextJs Tutorial for Beginners #77,13147,487,109,2022-06-24,Jun,80,596
394,CodeWithHarry,Creating Pages for the Dashboard | NextJs Tutorial for Beginners #76,12056,406,125,2022-06-23,Jun,68,531
395,CodeWithHarry,Conclusion & where to go from here | Portfolio Website + Blog Using Sanity.io #13,24153,636,155,2022-06-22,Jun,81,791
396,CodeWithHarry,Adding NavBar Component & Other UI Fixes | Portfolio Website + Blog Using Sanity.io #12,16373,367,106,2022-06-21,Jun,87,473
397,CodeWithHarry,Adding multiple profiles to our Portfolio | Portfolio Website + Blog Using Sanity.io #11,14582,442,98,2022-06-20,Jun,88,540
398,CodeWithHarry,Ultimate Docker Crash Course: Learn Docker within 30 Minutes!,113263,3726,349,2022-06-19,Jun,61,4075
399,CodeWithHarry,Run VS Code on Mobile Phone For Free 📲,173419,7271,394,2022-06-17,Jun,38,7665
400,CodeWithHarry,A closer look at GROQ | Portfolio Website + Blog Using Sanity.io #10,12117,361,82,2022-06-16,Jun,68,443
401,CodeWithHarry,The Love ♥ for C 💻,421155,33182,203,2022-06-15,Jun,18,33385
402,CodeWithHarry,Fetching Blog Template for our Project  | Portfolio Website + Blog Using Sanity.io #9,13919,406,102,2022-06-14,Jun,85,508
403,CodeWithHarry,Microsoft shutting down... ⚔⚔⚔,233568,16446,644,2022-06-13,Jun,30,17090
404,CodeWithHarry,Creating a Blog Page | Portfolio Website + Blog Using Sanity.io #8,14940,508,95,2022-06-13,Jun,66,603
405,CodeWithHarry,A Side Project 💻⌨🖱,229380,18848,64,2022-06-12,Jun,18,18912
406,CodeWithHarry,Creating Dashboard for Codeswear.com | NextJs Tutorial for Beginners #75,19525,494,100,2022-06-11,Jun,72,594
407,CodeWithHarry,Fetching blogs in our homepage | Portfolio Website + Blog Using Sanity.io #7,14015,383,74,2022-06-11,Jun,76,457
408,CodeWithHarry,Adding Template to our Next.js project | Portfolio Website + Blog Using Sanity.io #6,13940,427,64,2022-06-10,Jun,84,491
409,CodeWithHarry,No Degree 🎓,183447,12954,90,2022-06-08,Jun,11,13044
410,CodeWithHarry,Connecting Next.js app with Sanity.io | Portfolio Website + Blog Using Sanity.io #5,20952,509,104,2022-06-08,Jun,83,613
411,CodeWithHarry,Creating a Next.js app for Frontend | Portfolio Website + Blog Using Sanity.io #4,27510,809,97,2022-06-07,Jun,81,906
412,CodeWithHarry,Windows 9 - The Mystery OS  🔥,714015,40695,269,2022-06-05,Jun,29,40964
413,CodeWithHarry,Adding Rich Text to Blog in Sanity | Portfolio Website + Blog Using Sanity.io #3,22829,636,125,2022-06-04,Jun,80,761
414,CodeWithHarry,Game changing AI 🤖,1036866,109740,774,2022-06-03,Jun,18,110514
415,CodeWithHarry,Building Tic Tac Toe on iPhone 13 Pro Max Challenge (Multiplayer Game) 🔥,46883,1738,197,2022-06-03,Jun,72,1935
416,CodeWithHarry,Creating Content Structure for our Portfolio Site | Portfolio Website + Blog Using Sanity.io #2,34154,977,160,2022-06-02,Jun,95,1137
417,CodeWithHarry,Introduction to Sanity.io | Portfolio Website + Blog Using Sanity.io #1,102705,3070,364,2022-06-01,Jun,71,3434
418,CodeWithHarry,An Old Player of Programming Languages,140413,11151,101,2022-06-01,Jun,38,11252
419,CodeWithHarry,52 Years Old Code!,1187089,77015,289,2022-05-30,May,18,77304
420,CodeWithHarry,Lets Build an Action Game Using JavaScript with Kaboom.js 💥 (from scratch),80249,3698,626,2022-05-28,May,74,4324
421,CodeWithHarry,First Computer Game,138276,9143,199,2022-05-25,May,19,9342
422,CodeWithHarry,null vs NaN in JavaScript,60565,4912,56,2022-05-24,May,25,4968
423,CodeWithHarry,Deploying Codeswear.com to DigitalOcean | NextJs Tutorial for Beginners #74,26841,612,219,2022-05-23,May,75,831
424,CodeWithHarry,Index starts with 0 & not 1 - But why?,118303,11748,85,2022-05-22,May,38,11833
425,CodeWithHarry,Deploying our Strapi app to Digital ocean | Strapi Tutorial #10,25690,464,83,2022-05-22,May,63,547
426,CodeWithHarry,Creating Forgot Password Page | NextJs Tutorial for Beginners #73,17002,478,96,2022-05-22,May,65,574
427,CodeWithHarry,Microsoft Azure Developer League - An amazing platform from Microsoft for cloud computing,31714,1558,119,2022-05-21,May,89,1677
428,CodeWithHarry,Adding Order Success Page | Strapi Tutorial #9,14919,294,92,2022-05-21,May,46,386
429,CodeWithHarry,Creating MyAccount Section for CodesWear | NextJs Tutorial for Beginners #72,12786,341,65,2022-05-21,May,76,406
430,CodeWithHarry,PinCodes json + avoiding non serviceable Locations | NextJs Tutorial for Beginners #71,11585,354,93,2022-05-20,May,86,447
431,CodeWithHarry,Adding a payment gateway + Order success page | Strapi Tutorial #8,23090,474,65,2022-05-20,May,66,539
432,CodeWithHarry,Creating a Python based email marketing bot on Replit 🔥,45055,1794,193,2022-05-19,May,55,1987
433,CodeWithHarry,Displaying out of stock items | NextJs Tutorial for Beginners #70,14763,311,90,2022-05-18,May,65,401
434,CodeWithHarry,PayTM checksum Tampering check | NextJs Tutorial for Beginners #69,15102,415,52,2022-05-18,May,66,467
435,CodeWithHarry,Python Comics 💬💥💨,84278,6296,60,2022-05-17,May,17,6356
436,CodeWithHarry,Showing Sidebar only for few pages | NextJs Tutorial for Beginners #68,16998,364,106,2022-05-17,May,70,470
437,CodeWithHarry,"Creating Myntra Clone using HTML, CSS & JavaScript",438855,11001,433,2022-05-15,May,50,11434
438,CodeWithHarry,99% Python developers will get confused!,225002,11952,253,2022-05-14,May,40,12205
439,CodeWithHarry,Are Cracked Softwares Safe?,228046,16252,259,2022-05-13,May,27,16511
440,CodeWithHarry,5 Common Hacking Techniques,870820,83944,733,2022-05-12,May,27,84677
441,CodeWithHarry,"Improving frontend: Adding Home, About & Contact | Strapi Tutorial #7",29409,580,123,2022-05-12,May,69,703
442,CodeWithHarry,How to confuse a Python Developer?,551456,25643,655,2022-05-11,May,34,26298
443,CodeWithHarry,"Creating a Cart, Checkout and Buy button | Strapi Tutorial #6",28603,587,127,2022-05-11,May,61,714
444,CodeWithHarry,Windows for Free?,431375,30734,106,2022-05-10,May,17,30840
445,CodeWithHarry,What are Environment Variables | Hacking?,45361,1877,159,2022-05-10,May,41,2036
446,CodeWithHarry,Official Python Song 🎶🎵🎼🎹🎧,103181,7360,79,2022-05-09,May,26,7439
447,CodeWithHarry,Displaying products on our products page | Strapi Tutorial #5,33040,568,129,2022-05-09,May,61,697
448,CodeWithHarry,Google for sale! 😲,1635168,101873,557,2022-05-08,May,18,102430
449,CodeWithHarry,"Creating a Calculator using HTML, CSS & JavaScript",607986,15002,606,2022-05-08,May,50,15608
450,CodeWithHarry,The end of JavaScript 🤔,165158,13360,488,2022-05-07,May,23,13848
451,CodeWithHarry,Creating a Next.js E-Commerce app with strapi | Strapi Tutorial #4,35713,711,99,2022-05-07,May,66,810
452,CodeWithHarry,Stop Using React!,230284,13742,162,2022-05-06,May,17,13904
453,CodeWithHarry,Project: Creating Ecommerce application with strapi | Strapi Tutorial #3,35521,806,164,2022-05-06,May,72,970
454,CodeWithHarry,My favorite JavaScript Library!,72043,7076,83,2022-05-05,May,31,7159
455,CodeWithHarry,Installing PostgreSQL & Connecting to Strapi | Strapi Tutorial #2,42973,842,168,2022-05-05,May,65,1010
456,CodeWithHarry,Stop using console.log(),84373,8758,89,2022-05-04,May,24,8847
457,CodeWithHarry,Top Websites To Find Hackathons With Big Prizes!,62949,3713,181,2022-05-04,May,48,3894
458,CodeWithHarry,Python Programming and snake 🐍,69213,4830,45,2022-05-03,May,30,4875
459,CodeWithHarry,Complete Full Stack Web Developer Roadmap (2022 Edition),1358410,59554,10220,2022-05-03,May,56,69774
460,CodeWithHarry,The Money Making Programming Language (Atleast for me)!,67658,4195,601,2022-05-03,May,55,4796
461,CodeWithHarry,How many programming languages are there?,295960,18156,108,2022-05-02,May,41,18264
462,CodeWithHarry,Introduction to Strapi | Strapi Tutorial #1,152611,4422,559,2022-05-02,May,43,4981
463,CodeWithHarry,World's first Programming Language...,188902,11157,97,2022-05-01,May,37,11254
464,CodeWithHarry,How to get highest package in college?,348287,19219,889,2022-05-01,May,38,20108
465,CodeWithHarry,A Programmer's mistake....,847183,62800,339,2022-04-30,Apr,26,63139
466,CodeWithHarry,Python Project: Tic Tac Toe Game in Python 🔥,245626,6268,874,2022-04-30,Apr,44,7142
467,CodeWithHarry,PHP: Not a programming language,244813,18299,77,2022-04-29,Apr,31,18376
468,CodeWithHarry,🚫 Don't buy a MacBook 😢,319353,17793,2448,2022-04-29,Apr,23,20241
469,CodeWithHarry,5 Extremely Bad Python Habits,96216,9371,100,2022-04-28,Apr,29,9471
470,CodeWithHarry,Coding mein bug ko bug kyu kehte hain?,253199,21968,106,2022-04-27,Apr,38,22074
471,CodeWithHarry,Horizontal vs. Vertical Scaling - Learn Now!,40527,2195,323,2022-04-27,Apr,44,2518
472,CodeWithHarry,What exactly is JamStack?,21711,1471,148,2022-04-26,Apr,25,1619
473,CodeWithHarry,Top money making skills in web development 🔥,164528,8057,897,2022-04-25,Apr,44,8954
474,CodeWithHarry,Your Future in Web Development... (The Truth),710205,25687,959,2022-04-23,Apr,45,26646
475,CodeWithHarry,"Creating a landing page using HTML, CSS & JavaScript 🔥",178637,5059,360,2022-04-22,Apr,54,5419
476,CodeWithHarry,Data Analysis on House Pricing Data using MongoDB Aggregation Pipelines,34322,891,80,2022-04-21,Apr,71,971
477,CodeWithHarry,The most Profitable Skills in Coding!,495967,56716,1041,2022-04-20,Apr,37,57757
478,CodeWithHarry,Kya Web Developer ko Graphic Designing seekhni chahiye?,57545,3624,410,2022-04-19,Apr,55,4034
479,CodeWithHarry,PyMongo Tutorial & Connecting to a MongoDB Atlas Cluster Using Python,45303,1443,268,2022-04-17,Apr,69,1711
480,CodeWithHarry,Fixing Checkout Issues | NextJs Tutorial for Beginners #67,14295,355,100,2022-04-16,Apr,58,455
481,CodeWithHarry,Out of stock check in CodesWear.com | NextJs Tutorial for Beginners #66,11305,256,58,2022-04-16,Apr,71,314
482,CodeWithHarry,Pincode to city & state | NextJs Tutorial for Beginners #65,16619,392,78,2022-04-15,Apr,59,470
483,CodeWithHarry,Creating Order and Orders Page for the user | NextJs Tutorial for Beginners #64,9784,265,44,2022-04-15,Apr,79,309
484,CodeWithHarry,Initiating Order and Redirecting to Order Page | NextJs Tutorial for Beginners #63,18418,391,59,2022-04-14,Apr,82,450
485,CodeWithHarry,One Effective Sleeping Tip For Everyone!,85955,5745,118,2022-04-12,Apr,40,5863
486,CodeWithHarry,Should You buy an iPad? - The devil's advocate,44355,2279,236,2022-04-10,Apr,46,2515
487,CodeWithHarry,Adding Payment Gateway to Codeswear.com | NextJs Tutorial for Beginners #62,48746,877,142,2022-04-10,Apr,75,1019
488,CodeWithHarry,Adding Environment Variables to Codeswear.com | NextJs Tutorial for Beginners #61,10282,325,54,2022-04-10,Apr,81,379
489,CodeWithHarry,Creating Orders Page for Codeswear.com | NextJs Tutorial for Beginners #60,12025,339,46,2022-04-10,Apr,74,385
490,CodeWithHarry,Adding React top loading bar to Codeswear.com | NextJs Tutorial for Beginners #59,10721,266,36,2022-04-09,Apr,81,302
491,CodeWithHarry,Adding Login and Logout buttons to Codeswear.com | NextJs Tutorial for Beginners #58,13251,349,46,2022-04-09,Apr,84,395
492,CodeWithHarry,Introduction to JWT | NextJs Tutorial for Beginners #57,15541,422,50,2022-04-09,Apr,55,472
493,CodeWithHarry,Adding Encryption to login and signup for Codeswear.com | NextJs Tutorial for Beginners #56,16240,412,59,2022-04-09,Apr,91,471
494,CodeWithHarry,Creating Login Page for Codeswear.com | NextJs Tutorial for Beginners #55,12799,385,65,2022-04-08,Apr,73,450
495,CodeWithHarry,Creating Signup Page for Codeswear.com | NextJs Tutorial for Beginners #54,20248,488,44,2022-04-08,Apr,74,532
496,CodeWithHarry,"Customizing Hoodies, Mugs & Stickers Page for Codeswear.com | NextJs Tutorial for Beginners #53",13780,386,68,2022-04-07,Apr,95,454
497,CodeWithHarry,Adding React Toastify to Codeswear.com | NextJs Tutorial for Beginners #52,12620,342,44,2022-04-07,Apr,74,386
498,CodeWithHarry,How Would I Learn Web Development in 2022 If I Could Start Over 🔥🔥,548499,26880,935,2022-04-04,Apr,66,27815
499,CodeWithHarry,"Making the ""Buy Now"" button for Codeswear.com | NextJs Tutorial for Beginners #51",21821,565,82,2022-04-03,Apr,81,647
500,CodeWithHarry,Replacing Dummy Text on Codeswear.com | NextJs Tutorial for Beginners #50,14354,279,46,2022-04-03,Apr,73,325
501,CodeWithHarry,Displaying Tshirt Variants on product page | NextJs Tutorial for Beginners #49,17620,416,114,2022-04-03,Apr,78,530
502,CodeWithHarry,Displaying Tshirts on Codeswear.com | NextJs Tutorial for Beginners #48,14021,399,60,2022-04-02,Apr,71,459
503,CodeWithHarry,Creating APIs for Codeswear.com | NextJs Tutorial for Beginners #47,21316,519,98,2022-04-02,Apr,67,617
504,CodeWithHarry,Adding MongoDB Database to Codeswear.com | NextJs Tutorial for Beginners #46,27684,608,60,2022-04-02,Apr,76,668
505,CodeWithHarry,Creating Login & Signup Page Design for Codeswear.com | NextJs Tutorial for Beginners #45,21023,555,90,2022-04-01,Apr,89,645
506,CodeWithHarry,Creating Orders Page for Codeswear.com | NextJs Tutorial for Beginners #44,13104,443,47,2022-04-01,Apr,74,490
507,CodeWithHarry,Improving Sidebar & Checkout Page for Codeswear.com | NextJs Tutorial for Beginners #43,15422,460,108,2022-03-31,Mar,87,568
508,CodeWithHarry,One Lesson from ₹500 Currency note 🔥,186482,27556,490,2022-03-29,Mar,36,28046
509,CodeWithHarry,PHP in 8 Minutes 🔥,129898,5309,316,2022-03-28,Mar,18,5625
510,CodeWithHarry,Creating Cart State for Codeswear.com | NextJs Tutorial for Beginners #42,20891,563,131,2022-03-28,Mar,73,694
511,CodeWithHarry,Adding Pincode Serviceability Check on Codeswear.com | NextJs Tutorial for Beginners #41,17584,556,93,2022-03-27,Mar,88,649
512,CodeWithHarry,The *most* valuable thing you have as a Developer!,73156,7306,106,2022-03-25,Mar,50,7412
513,CodeWithHarry,Designing Product Page for Codeswear.com | NextJs Tutorial for Beginners #40,17114,547,113,2022-03-25,Mar,76,660
514,CodeWithHarry,Designing the Cart Sidebar for Codeswear.com | NextJs Tutorial for Beginners #39,24656,631,93,2022-03-24,Mar,80,724
515,CodeWithHarry,"Designing Mugs, Sticker & Hoodies page for Codeswear.com | NextJs Tutorial for Beginners #38",17299,544,108,2022-03-24,Mar,92,652
516,CodeWithHarry,Designing the Tshirts Page for Codeswear.com | NextJs Tutorial for Beginners #37,19349,585,86,2022-03-23,Mar,80,671
517,CodeWithHarry,5 Top Skills to learn in 2022,401973,20615,1072,2022-03-21,Mar,29,21687
518,CodeWithHarry,"Creating NavBar, Footer & HomePage for Codeswear.com | NextJs Tutorial for Beginners #36",28715,788,124,2022-03-20,Mar,88,912
519,CodeWithHarry,Creating Pages for Codeswear.com | NextJs Tutorial for Beginners #35,22132,679,141,2022-03-19,Mar,68,820
520,CodeWithHarry,3 tips for better sleep (Sleep with Science),131838,13160,152,2022-03-18,Mar,44,13312
521,CodeWithHarry,Codeswear.com - Project Setup using Tailwind CSS | NextJs Tutorial for Beginners #34,24716,666,105,2022-03-18,Mar,84,771
522,CodeWithHarry,Project 2: Codeswear.com - A Next.js powered E-Commerce Store | NextJs Tutorial for Beginners #33,29300,948,115,2022-03-17,Mar,97,1063
523,CodeWithHarry,One Tip that made me a Fast Typist!,382222,43806,292,2022-03-16,Mar,35,44098
524,CodeWithHarry,Adding huntingcoder.com Domain and  Search Console | NextJs Tutorial for Beginners #32,16430,502,119,2022-03-16,Mar,86,621
525,CodeWithHarry,The Feynman Technique for Learning Anything 🔥,117181,13238,195,2022-03-14,Mar,45,13433
526,CodeWithHarry,5 Effective Tips for taking Notes,90691,9329,136,2022-03-13,Mar,33,9465
527,CodeWithHarry,Tailwind CSS in 6 Minutes 🔥,49355,2116,215,2022-03-12,Mar,27,2331
528,CodeWithHarry,Deploying Hunting Coder | NextJs Tutorial for Beginners #31,20054,539,91,2022-03-11,Mar,59,630
529,CodeWithHarry,Adding Responsive Design to Hunting Coder | NextJs Tutorial for Beginners #30,14285,386,70,2022-03-11,Mar,77,456
530,CodeWithHarry,Adding Infinite Scroll to Hunting Coder | NextJs Tutorial for Beginners #29,19186,539,102,2022-03-10,Mar,75,641
531,CodeWithHarry,Django in 8 Minutes 🔥,98837,3768,270,2022-03-08,Mar,21,4038
532,CodeWithHarry,Styling Fixes in our Hunting coder Blog | NextJs Tutorial for Beginners #28,14509,430,99,2022-03-07,Mar,75,529
533,CodeWithHarry,Designing the About Page | NextJs Tutorial for Beginners #27,12654,410,52,2022-03-07,Mar,60,462
534,CodeWithHarry,Designing the /contact FrontEnd Page | NextJs Tutorial for Beginners #26,16531,549,109,2022-03-06,Mar,72,658
535,CodeWithHarry,Creating an API to save Contact Data | NextJs Tutorial for Beginners #25,21231,635,67,2022-03-06,Mar,72,702
536,CodeWithHarry,Rendering HTML text using dangerouslySetInnerHTML in Next.js | NextJs Tutorial for Beginners #24,20763,637,79,2022-03-05,Mar,96,716
537,CodeWithHarry,"Static site generation, getStaticProps() & getStaticPaths | NextJs Tutorial for Beginners #23",28499,769,109,2022-03-04,Mar,93,878
538,CodeWithHarry,Flask in 6 Minutes 🔥,68952,2777,227,2022-03-02,Mar,20,3004
539,CodeWithHarry,Server Side Rendering - getServerSideProps() in Next.js | NextJs Tutorial for Beginners #22,36703,966,124,2022-03-01,Mar,91,1090
540,CodeWithHarry,Prerendering Strategies in Next.js | NextJs Tutorial for Beginners #21,22163,734,85,2022-02-28,Feb,70,819
541,CodeWithHarry,Fetching BlogPost using /getblog Endpoint | NextJs Tutorial for Beginners #20,23823,631,78,2022-02-27,Feb,77,709
542,CodeWithHarry,Using the API Endpoints | NextJs Tutorial for Beginners #19,27692,747,86,2022-02-27,Feb,59,833
543,CodeWithHarry,JavaScript in 8 Minutes 👩‍💻,180248,7813,388,2022-02-25,Feb,27,8201
544,CodeWithHarry,Creating endpoints to get one/all blogposts | NextJs Tutorial for Beginners #18,28689,731,67,2022-02-25,Feb,79,798
545,CodeWithHarry,Introduction to API Routes in Next.js | NextJs Tutorial for Beginners #17,30210,820,87,2022-02-24,Feb,73,907
546,CodeWithHarry,Adding blog jsons as data | NextJs Tutorial for Beginners #16,25699,762,85,2022-02-24,Feb,61,847
547,CodeWithHarry,Creating Blog and Blogpost page | NextJs Tutorial for Beginners #15,30125,865,97,2022-02-23,Feb,67,962
548,CodeWithHarry,Displaying Navbar on all pages | NextJs Tutorial for Beginners #14,40104,901,79,2022-02-23,Feb,66,980
549,CodeWithHarry,Basic Cleanup of Hunting Coder Blog | NextJs Tutorial for Beginners #13,23976,755,100,2022-02-22,Feb,71,855
550,CodeWithHarry,Styled jsx in Next.js | NextJs Tutorial for Beginners #12,25257,866,94,2022-02-22,Feb,57,960
551,CodeWithHarry,Java in 7 Minutes 🔥,186024,8736,538,2022-02-20,Feb,19,9274
552,CodeWithHarry,Adding Global Styles in Next.js | NextJs Tutorial for Beginners #11,27922,841,77,2022-02-19,Feb,67,918
553,CodeWithHarry,[Updated Feb 2022] Laptop models to buy around 70k budget,130570,5833,879,2022-02-17,Feb,57,6712
554,CodeWithHarry,Component Level CSS in Next.js | NextJs Tutorial for Beginners #10,36564,1077,124,2022-02-16,Feb,66,1201
555,CodeWithHarry,Link component in Next.js -  Understanding next/link | NextJs Tutorial for Beginners #9,37182,948,107,2022-02-15,Feb,87,1055
556,CodeWithHarry,C++ in 5 Minutes 🔥,123915,6631,379,2022-02-14,Feb,18,7010
557,CodeWithHarry,"C++, Java or Python? The best Language for College Placements in India",205579,10576,550,2022-02-13,Feb,70,11126
558,CodeWithHarry,"Tailwind CSS Course Conclusion, Wrap-up & where to go from here",42288,2625,336,2022-02-12,Feb,63,2961
559,CodeWithHarry,Creating Multiple Pages in Next.js | NextJs Tutorial for Beginners #8,44626,1232,159,2022-02-11,Feb,69,1391
560,CodeWithHarry,Blogging in 2022? 💻,41609,2377,274,2022-02-10,Feb,19,2651
561,CodeWithHarry,Image Component in Next.js | NextJs Tutorial for Beginners #7,46309,1188,164,2022-02-09,Feb,61,1352
562,CodeWithHarry,CSS in 7 Minutes 🔥,244161,9776,345,2022-02-09,Feb,18,10121
563,CodeWithHarry,Head and Script Component in Next.js | NextJs Tutorial for Beginners #6,49343,1337,118,2022-02-08,Feb,71,1455
564,CodeWithHarry,Project 1: Hunting Coder - A Coder's Blog | NextJs Tutorial for Beginners #5,70013,2304,214,2022-02-07,Feb,76,2518
565,CodeWithHarry,5 Typing Softwares I used to improve typing speed 🔥,62964,3278,305,2022-02-06,Feb,51,3583
566,CodeWithHarry,JavaScript and React Refresher for Next.js | NextJs Tutorial for Beginners #4,54211,1563,227,2022-02-06,Feb,77,1790
567,CodeWithHarry,99.9% developers don't use this in VS Code! 🔥 #shorts,324092,31339,444,2022-02-05,Feb,53,31783
568,CodeWithHarry,"Don't Use HTML, CSS & JavaScript (Do this instead!)",360762,14444,652,2022-02-04,Feb,51,15096
569,CodeWithHarry,Project 2: Microsoft Clone (Responsive) in Tailwind CSS: Tailwind Tutorial #15,95081,2388,247,2022-02-03,Feb,78,2635
570,CodeWithHarry,HTML id vs class 🔥 #shorts,92332,9302,112,2022-02-03,Feb,26,9414
571,CodeWithHarry,HTML in 9 Minutes (in Hindi) 🌐,346581,14520,524,2022-02-02,Feb,30,15044
572,CodeWithHarry,File Based Routing in Next.js | NextJs Tutorial for Beginners #3,75729,2056,252,2022-02-01,Feb,64,2308
573,CodeWithHarry,5 Typing Websites I used to Master Typing!,91220,5752,439,2022-01-31,Jan,42,6191
574,CodeWithHarry,Our first Next.js website | NextJs Tutorial for Beginners #2,159773,3919,663,2022-01-30,Jan,60,4582
575,CodeWithHarry,Introduction to Next.js | NextJs Tutorial for Beginners #1,306539,8121,765,2022-01-29,Jan,58,8886
576,CodeWithHarry,The Harsh Truth About Typing wrt Coding 😐,129138,7249,507,2022-01-26,Jan,41,7756
577,CodeWithHarry,Wrap Tabs in VS Code is an awesome feature! 🔥 #shorts,114528,8639,148,2022-01-24,Jan,53,8787
578,CodeWithHarry,⚠WARNING: Don't Learn Tailwind CSS before Learning CSS!,42955,2439,263,2022-01-23,Jan,55,2702
579,CodeWithHarry,Must Try this VS Code Hack #shorts 🔥,92956,8445,179,2022-01-22,Jan,36,8624
580,CodeWithHarry,Is it impossible to master CSS?,149965,8239,553,2022-01-21,Jan,31,8792
581,CodeWithHarry,Top 5 Programming Languages for 2022 🔥,411451,18378,1172,2022-01-19,Jan,38,19550
582,CodeWithHarry,Project 1: Facebook Clone in Tailwind CSS: Tailwind Tutorial #14,87147,2459,257,2022-01-18,Jan,64,2716
583,CodeWithHarry,Deploying a Tailwind Website to Production : Tailwind Tutorial #13,41657,1436,167,2022-01-17,Jan,66,1603
584,CodeWithHarry,Customizing Tailwind CSS using tailwind.config.js file: Tailwind Tutorial #12,41586,1452,121,2022-01-16,Jan,77,1573
585,CodeWithHarry,When to use @apply and @layer directive?: Tailwind Tutorial #11,29887,1286,102,2022-01-15,Jan,63,1388
586,CodeWithHarry,C Language in 9 Minutes (in Hindi) 🔥,487514,23737,1271,2022-01-14,Jan,36,25008
587,CodeWithHarry,@layer Directive in Tailwind: Tailwind Tutorial #10,34525,1461,160,2022-01-13,Jan,51,1621
588,CodeWithHarry,@apply directive in Tailwind CSS: Tailwind Tutorial #9,42762,1641,159,2022-01-12,Jan,54,1800
589,CodeWithHarry,"Hover, Focus & Other States in Tailwind CSS : Tailwind Tutorial #8",53101,1885,300,2022-01-08,Jan,66,2185
590,CodeWithHarry,Creating Responsive Designs in Tailwind CSS : Tailwind Tutorial #7,64169,2344,315,2022-01-07,Jan,66,2659
591,CodeWithHarry,Square Bracket Notation in Tailwind CSS : Tailwind Tutorial #6,50777,1850,195,2022-01-05,Jan,62,2045
592,CodeWithHarry,"Margins, Borders & Padding in Tailwind CSS : Tailwind Tutorial #5",58168,1818,179,2022-01-04,Jan,65,1997
593,CodeWithHarry,Fonts & Sizing : Tailwind Tutorial #4,78097,2251,193,2022-01-03,Jan,37,2444
594,CodeWithHarry,Why use Tailwind CSS? : Tailwind Tutorial #3,97949,3147,314,2022-01-02,Jan,44,3461
595,CodeWithHarry,Sweet Spot PC Build for ML & Android Studio 🔥,156815,7938,655,2022-01-01,Jan,45,8593
596,CodeWithHarry,Our First Tailwind CSS Website: Tailwind Tutorial #2,212641,5270,817,2021-12-31,Dec,52,6087
597,CodeWithHarry,Introduction to Tailwind CSS & Utility first Workflow: Tailwind Tutorial #1,445374,12244,1063,2021-12-30,Dec,75,13307
598,CodeWithHarry,Python in 8 Minutes (in Hindi) 🐍,1014041,40230,1140,2021-12-28,Dec,32,41370
599,CodeWithHarry,Strapi Headless CMS can save a lot of API Development time 🔥 #shorts,85399,6682,130,2021-12-23,Dec,68,6812
600,CodeWithHarry,"Personal Portfolio website using pure HTML, CSS and JavaScript",1186873,33899,1987,2021-12-22,Dec,62,35886
601,CodeWithHarry,Bootstrap in 2022 - A big NO ❓❓,321994,11558,1013,2021-12-21,Dec,31,12571
602,CodeWithHarry,5 Ways to Host a Website for Free!!! 🆓🙌,470265,50321,295,2021-12-21,Dec,39,50616
603,CodeWithHarry,7 Coding Myths - Busted! 🕵️‍♂️,226496,14277,684,2021-12-20,Dec,30,14961
604,CodeWithHarry,Why everyone should learn to Code in 2022? (The Reason!),85020,5869,581,2021-12-18,Dec,56,6450
605,CodeWithHarry,5 ways to customize chrome homepage 🔥 #shorts,121087,12071,126,2021-12-17,Dec,45,12197
606,CodeWithHarry,Landing Page vs Website - The Difference! 🔥 #shorts,73358,5438,99,2021-12-13,Dec,51,5537
607,CodeWithHarry,GitHub Desktop saves a lot of time & hassles 🔥 #shorts,75665,6179,135,2021-12-09,Dec,54,6314
608,CodeWithHarry,Python Quiz: 99.9% wont get this right! #shorts,165815,12072,286,2021-12-08,Dec,47,12358
609,CodeWithHarry,Can you learn Coding post 30?,72509,3221,532,2021-12-07,Dec,29,3753
610,CodeWithHarry,Live Preview HTML in VS Code 🔥,168983,16105,187,2021-12-07,Dec,30,16292
611,CodeWithHarry,Yarn Vs Npm #shorts,47776,3555,124,2021-12-06,Dec,19,3679
612,CodeWithHarry,Fun Things to do with Google Search #shorts 🔥,186112,16616,141,2021-12-05,Dec,45,16757
613,CodeWithHarry,Lively Wallpapers is an amazing Windows 11 Application 🔥 #shorts,66015,5082,124,2021-12-04,Dec,64,5206
614,CodeWithHarry,Image search in Chrome - No Extension #shorts 🔥,57969,3952,118,2021-12-03,Dec,47,4070
615,CodeWithHarry,What if you are not enjoying Coding?,365293,19586,951,2021-12-02,Dec,36,20537
616,CodeWithHarry,Pretty print JavaScript objects in NodeJS,59632,4755,60,2021-12-02,Dec,41,4815
617,CodeWithHarry,Find and delete unused node_module folders #shorts,269219,31464,306,2021-12-01,Dec,50,31770
618,CodeWithHarry,Amazing Facts About Windows 11 🔥 #shorts,194594,17954,111,2021-11-30,Nov,40,18065
619,CodeWithHarry,What *is* Coding?,205860,11786,637,2021-11-29,Nov,17,12423
620,CodeWithHarry,These 5 Chrome Extensions are amazing! 🔥 #shorts,168475,17119,150,2021-11-29,Nov,48,17269
621,CodeWithHarry,Advanced Google Search Tips & Tricks! 🔥 #shorts,84017,8558,77,2021-11-28,Nov,47,8635
622,CodeWithHarry,C vs C++ in 2022?,241589,15088,776,2021-11-27,Nov,17,15864
623,CodeWithHarry,Make Windows Look like MacOS using this! 🔥 #shorts,144741,9760,146,2021-11-27,Nov,50,9906
624,CodeWithHarry,Search Google Like a Pro! 🔥 #shorts,116536,11186,156,2021-11-26,Nov,35,11342
625,CodeWithHarry,Find Fonts on any Website using this free tool! 🔥 #shorts,56953,6301,114,2021-11-25,Nov,57,6415
626,CodeWithHarry,TabGroups in Chrome is very helpful for Coders 🔥 #shorts,60196,4578,83,2021-11-24,Nov,56,4661
627,CodeWithHarry,Prims Minimum Spanning Tree Algorithm (Step by Step with examples),119261,3122,566,2021-11-23,Nov,66,3688
628,CodeWithHarry,99.9% will fail to answer this JavaScript Question #shorts,649737,48164,744,2021-11-23,Nov,58,48908
629,CodeWithHarry,Start Chrome dino Trex game with the score of your choice #shorts,83155,6150,116,2021-11-22,Nov,65,6266
630,CodeWithHarry,"""Previous Cursor Location"" feature of VS Code will save you a lot of time 🔥 #shorts",156353,14263,103,2021-11-21,Nov,83,14366
631,CodeWithHarry,C++ करूँ या Java? [All Doubts Cleared],632286,29079,1442,2021-11-20,Nov,38,30521
632,CodeWithHarry,This is my favorite VS Code Feature 🔥 #shorts,253144,29590,241,2021-11-20,Nov,45,29831
633,CodeWithHarry,Calculating Spanning tree Cost & Minimum Spanning Tree,66802,2179,208,2021-11-19,Nov,54,2387
634,CodeWithHarry,These Unique Microsoft Edge Features are not present in Chrome **yet** 🔥 #shorts,261274,25222,204,2021-11-19,Nov,80,25426
635,CodeWithHarry,Spanning Trees & maximum no of possible spanning trees for complete graphs,67665,2156,279,2021-11-18,Nov,74,2435
636,CodeWithHarry,Know this to rank your site in Google 🔥 #shorts,61349,5844,73,2021-11-18,Nov,47,5917
637,CodeWithHarry,Convert Image to Text directly in Chrome - No external application needed 🔥 #shorts,111240,9798,173,2021-11-17,Nov,83,9971
638,CodeWithHarry,This Chrome feature to Manage your tabs is awesome! #shorts,79279,5510,239,2021-11-16,Nov,59,5749
639,CodeWithHarry,Must learn this Chrome Tab *Trick* to maximize productivity 🔥#shorts,97787,8555,267,2021-11-15,Nov,68,8822
640,CodeWithHarry,Enable this secret AI feature in Chrome 🔥 (Right Now!) #shorts,152304,13814,301,2021-11-14,Nov,62,14115
641,CodeWithHarry,NextJs in 7 Minutes 🔥,197232,8411,469,2021-11-13,Nov,21,8880
642,CodeWithHarry,This tool will help you read any PDF as Audiobook 🔥 #shorts,75177,6426,137,2021-11-13,Nov,59,6563
643,CodeWithHarry,Hate Mathematics? Here's where Maths is not required for Coding?,144225,10575,728,2021-11-12,Nov,64,11303
644,CodeWithHarry,You cannot go back to Windows 10 From Windows 11 😢 #shorts,113899,7680,225,2021-11-12,Nov,58,7905
645,CodeWithHarry,My Secret Technique to Learn a Programming Language/Technology (Step by Step),179291,11948,485,2021-11-11,Nov,77,12433
646,CodeWithHarry,Watch YouTube Lectures Like a Pro 🔥 #shorts,199278,20131,296,2021-11-11,Nov,43,20427
647,CodeWithHarry,DFS Implementation in C | C Code For Depth First Search,85666,2259,178,2021-11-10,Nov,55,2437
648,CodeWithHarry,Another Free Microsoft App for your Mobile #shorts 🔥,85627,6790,150,2021-11-10,Nov,52,6940
649,CodeWithHarry,Why are some people so good at coding? (Copy These),194561,12712,748,2021-11-09,Nov,51,13460
650,CodeWithHarry,A clever trick to use Inspect Element smartly in Chrome 🔥 #shorts,698518,72621,350,2021-11-09,Nov,65,72971
651,CodeWithHarry,Know this before upgrading to Windows 11 😡,338275,15313,2407,2021-11-08,Nov,42,17720
652,CodeWithHarry,All Web Developers should know this Chrome Internet Speed Trick! 🔥 #shorts,285591,30071,328,2021-11-08,Nov,74,30399
653,CodeWithHarry,Enable these options in VS Code now! #shorts,496156,35732,340,2021-11-07,Nov,44,36072
654,CodeWithHarry,Depth First Search (DFS) Graph Traversal in Data Structures,113638,3138,206,2021-11-06,Nov,59,3344
655,CodeWithHarry,This VS Code feature will change the way you present 🔥 #shorts,142308,12943,255,2021-11-06,Nov,62,13198
656,CodeWithHarry,Why I am Uninstalling Windows 11 😢,411667,23600,2141,2021-11-05,Nov,34,25741
657,CodeWithHarry,How a Coder Plays Google Chrome’s T-rex Game Using JavaScript! #shorts,4418167,291412,422,2021-11-05,Nov,70,291834
658,CodeWithHarry,BFS Implementation in C | C Code For Breadth First Search,143839,3048,278,2021-11-04,Nov,57,3326
659,CodeWithHarry,How to install Fonts from One Computer to Another in Windows? #shorts,70880,4072,192,2021-11-04,Nov,69,4264
660,CodeWithHarry,Breadth First Search (BFS) Graph Traversal in Data Structures,156166,4323,234,2021-11-03,Nov,61,4557
661,CodeWithHarry,This JavaScript trick will amaze your friends 🔥 #shorts,861642,73238,725,2021-11-03,Nov,55,73963
662,CodeWithHarry,Use this *free* Microsoft application to improve your productivity #shorts,137022,8010,323,2021-11-02,Nov,74,8333
663,CodeWithHarry,5 HTML Tags I bet you didn't know about! #shorts,1014644,109900,2068,2021-11-01,Nov,48,111968
664,CodeWithHarry,The Logic Building Mindset you need to solve any Competitive Coding Question!,615647,31265,895,2021-10-31,Oct,77,32160
665,CodeWithHarry,How Much Does Coding Help in Stock Market (Money Making Tips) 🔥,155178,8356,508,2021-10-30,Oct,63,8864
666,CodeWithHarry,Downsides of a being a Software Dev - by a Software Dev!,72157,5003,541,2021-10-29,Oct,56,5544
667,CodeWithHarry,Choose this out of Competitive Programming Vs Software Development in College!,119432,8364,487,2021-10-28,Oct,78,8851
668,CodeWithHarry,Windows 11 Upgrade + Get those missing features back! 🔥,116550,6361,1168,2021-10-27,Oct,55,7529
669,CodeWithHarry,Which Resource to Choose for Learning Coding | Book? Videos? Text or...,180998,10333,765,2021-10-25,Oct,71,11098
670,CodeWithHarry,1.5 Lakhs/Month Coding Job Without a Degree? 😲😲,440612,21315,1076,2021-10-24,Oct,47,22391
671,CodeWithHarry,Will Web Development Eventually Die?,133879,8693,677,2021-10-23,Oct,36,9370
672,CodeWithHarry,Graph traversal & Graph traversal algorithms,103890,3948,393,2021-10-22,Oct,44,4341
673,CodeWithHarry,Data Science vs Software development - Which career path is the most Rewarding?,488645,22858,1134,2021-10-21,Oct,79,23992
674,CodeWithHarry,"Representation of Graphs - Adjacency List, Adjacency Matrix & Other Representations",143863,4358,351,2021-10-20,Oct,83,4709
675,CodeWithHarry,Dont Do Last Moment study but... (Few Personal Tricks),44459,3649,630,2021-10-19,Oct,54,4279
676,CodeWithHarry,Introduction to Graphs | Graph Data Structure,224770,6521,474,2021-10-18,Oct,45,6995
677,CodeWithHarry,Perks of being a Software Engineer 😍😍 - Should you be one?,134947,10985,797,2021-10-17,Oct,58,11782
678,CodeWithHarry,"C Code For AVL Tree Insertion & Rotation (LL, RR, LR & RL Rotation)",102311,3084,415,2021-10-16,Oct,67,3499
679,CodeWithHarry,How To Get Started With Coding (3 Minutes),128449,9860,520,2021-10-15,Oct,42,10380
680,CodeWithHarry,How I remember syntax while programming?,80146,5429,374,2021-10-14,Oct,40,5803
681,CodeWithHarry,"Tic Tac Toe Using only HTML, CSS & JavaScript 🔥🔥",446661,15787,1886,2021-10-13,Oct,48,17673
682,CodeWithHarry,How Long Does it Take to Learn a Programming Language? (Job Ready),579177,33989,1283,2021-10-11,Oct,66,35272
683,CodeWithHarry,"Creating a Spotify Clone Using HTML, CSS & JavaScript Only | JavaScript Music Player🔥🔥",1476730,33070,2367,2021-10-10,Oct,86,35437
684,CodeWithHarry,How Would I Learn To Code (If I Was To Start Over) 🔥🔥,1749921,85012,2273,2021-10-09,Oct,53,87285
685,CodeWithHarry,Should You Upgrade To Windows 11 Just Yet?,108895,6498,733,2021-10-08,Oct,42,7231
686,CodeWithHarry,Should I Learn Web Development or Android Development? (The Answer!),470088,25074,1231,2021-10-07,Oct,68,26305
687,CodeWithHarry,Introvert Vs Extrovert - Who gets more successful?,162778,11856,958,2021-10-06,Oct,50,12814
688,CodeWithHarry,Updating state from a different component in Redux | Complete React Course in Hindi #78,114059,2575,650,2021-10-05,Oct,87,3225
689,CodeWithHarry,College Placements - Harsh Truth!,104422,6457,580,2021-10-04,Oct,33,7037
690,CodeWithHarry,PC Builds for Coders - Budget PCs You Can Build This Festive Season 🔥,88193,5247,504,2021-10-03,Oct,69,5751
691,CodeWithHarry,Accessing State in Redux | Complete React Course in Hindi #77,66757,1374,101,2021-10-03,Oct,61,1475
692,CodeWithHarry,Laptop Models to Buy this Festive Season (Google Sheet Included) 🔥,379055,21962,2116,2021-10-01,Oct,66,24078
693,CodeWithHarry,"Student Offers, Cashbacks & Programs to join - Save Money as a student 🔥",147482,9862,629,2021-09-30,Sep,72,10491
694,CodeWithHarry,Fastest Way To Get Started With Web Development (3 Minutes),192969,13508,738,2021-09-29,Sep,59,14246
695,CodeWithHarry,Creating a Redux Store | Complete React Course in Hindi #76,86761,1647,185,2021-09-29,Sep,59,1832
696,CodeWithHarry,Avoid *these* Things in College (IMPORTANT!),327534,24632,1095,2021-09-28,Sep,44,25727
697,CodeWithHarry,Personal Early Realization Technique for productivity (3 minute technique) 🔥🔥,72867,6920,523,2021-09-27,Sep,77,7443
698,CodeWithHarry,Creating a Reducer & Action Creator in Redux | Complete React Course in Hindi #75,95110,1949,166,2021-09-27,Sep,81,2115
699,CodeWithHarry,College Will Not Teach You Coding - Here's Why!,398357,29306,1394,2021-09-26,Sep,47,30700
700,CodeWithHarry,Mind you - This is the best Time to Start Coding 💻 🔥,49591,4759,704,2021-09-25,Sep,52,5463
701,CodeWithHarry,Can You Learn Coding as a Commerce/Mechanical/Arts Student?,177394,12565,1366,2021-09-24,Sep,59,13931
702,CodeWithHarry,Why should you (not) write GATE 2022?,382924,19647,1920,2021-09-23,Sep,37,21567
703,CodeWithHarry,5 Habits of Highly Successful Coders 🔥,187222,13963,629,2021-09-22,Sep,38,14592
704,CodeWithHarry,Is English Important for Placements?,252721,17283,993,2021-09-21,Sep,36,18276
705,CodeWithHarry,Can you Code a Product from Development to Deployment (as the only coder)?,61617,4733,472,2021-09-20,Sep,74,5205
706,CodeWithHarry,99.9% Freelancers Will Fail Because of This!,655809,33918,1550,2021-09-19,Sep,44,35468
707,CodeWithHarry,5 Coding Strategies I Wish I knew since First Year of College 🔥,479005,31348,1137,2021-09-18,Sep,63,32485
708,CodeWithHarry,"All About Hackathons - How to Find, Participate & Win? 🔥",309240,16693,618,2021-09-17,Sep,56,17311
709,CodeWithHarry,Is the IIT tag really important? - My Opinions & Advises 🔥🔥,403086,32157,2683,2021-09-16,Sep,59,34840
710,CodeWithHarry,Setting up a React Application for Redux | Complete React Course in Hindi #74,97362,2054,240,2021-09-15,Sep,77,2294
711,CodeWithHarry,How to watch Online Coding Tutorials Effectively! 🔥🔥,118515,9459,601,2021-09-14,Sep,52,10060
712,CodeWithHarry,Introduction to Redux | Complete React Course in Hindi #73,151064,3513,250,2021-09-13,Sep,58,3763
713,CodeWithHarry,Fetching User Specific Notes in iNotebook | Complete React Course in Hindi #72,49891,1488,529,2021-09-12,Sep,78,2017
714,CodeWithHarry,"Adding Alerts to Login, Signup & Notes Component of iNotebook | Complete React Course in Hindi #71",36569,1076,130,2021-09-12,Sep,98,1206
715,CodeWithHarry,Should You use Libraries Or Code from Scratch?,32813,2015,253,2021-09-11,Sep,46,2268
716,CodeWithHarry,5 JavaScript Concepts Everyone Should Learn! 🔥,124774,7211,944,2021-09-10,Sep,46,8155
717,CodeWithHarry,Should You Mention Copied Projects From Internet in Your Resume?,403267,16286,588,2021-09-08,Sep,64,16874
718,CodeWithHarry,Adding SignUp Component to iNotebook | Complete React Course in Hindi #70,41002,1436,180,2021-09-07,Sep,73,1616
719,CodeWithHarry,Adding Login Component to iNotebook | Complete React Course in Hindi #69,51313,1476,205,2021-09-07,Sep,72,1681
720,CodeWithHarry,Adding Frontend Validation + Few Fixes in iNotebook | Complete React Course in Hindi #68,32508,1120,157,2021-09-07,Sep,88,1277
721,CodeWithHarry,Updating Notes on edit in the UI using React | Complete React Course in Hindi #67,33845,993,143,2021-09-07,Sep,81,1136
722,CodeWithHarry,Adding a Modal for Editing Notes | Complete React Course in Hindi #66,51370,1148,308,2021-09-07,Sep,69,1456
723,CodeWithHarry,"Adding ""fetch notes"" functionality to iNotebook | Complete React Course in Hindi #65",43451,1193,245,2021-09-07,Sep,84,1438
724,CodeWithHarry,"Adding ""delete note"" functionality to iNotebook | Complete React Course in Hindi #64",32971,1060,79,2021-09-07,Sep,84,1139
725,CodeWithHarry,Adding AddNote component to iNotebook | Complete React Course in Hindi #63,42800,1221,135,2021-09-07,Sep,74,1356
726,CodeWithHarry,Adding font awesome icons to iNotebook | Complete React Course in Hindi #62,46222,1615,134,2021-09-06,Sep,75,1749
727,CodeWithHarry,iNotebook: Adding NoteItem in a Separate Note component | Complete React Course in Hindi #61,36326,1344,76,2021-09-06,Sep,92,1420
728,CodeWithHarry,iNotebook: Fetching Notes from Context | Complete React Course in Hindi #60,46841,1381,102,2021-09-06,Sep,75,1483
729,CodeWithHarry,useLocation Hook in React | Complete React Course in Hindi #59,48635,1722,126,2021-09-06,Sep,62,1848
730,CodeWithHarry,useContext hook: Using React Context API | Complete React Course in Hindi #58,136627,3256,281,2021-09-05,Sep,77,3537
731,CodeWithHarry,Introduction to React Context API | Complete React Course in Hindi #57,66632,2195,127,2021-09-05,Sep,70,2322
732,CodeWithHarry,Creating Navbar and Routes | Complete React Course in Hindi #56,73369,1653,131,2021-09-05,Sep,63,1784
733,CodeWithHarry,iNotebook React Project Setup | Complete React Course in Hindi #55,46546,1524,152,2021-09-05,Sep,66,1676
734,CodeWithHarry,Endpoint for deleting a Note | Complete React Course in Hindi #54,34045,1770,404,2021-09-04,Sep,65,2174
735,CodeWithHarry,Updating an existing Note | Complete React Course in Hindi #53,37853,1324,143,2021-09-04,Sep,62,1467
736,CodeWithHarry,Fetching all notes & Adding a Note | Complete React Course in Hindi #52,50984,1409,191,2021-09-04,Sep,71,1600
737,CodeWithHarry,Creating a middleware to decode user from a JWT | Complete React Course in Hindi #51,56966,1624,289,2021-09-04,Sep,84,1913
738,CodeWithHarry,Creating Login Endpoint & sending auth token| Complete React Course in Hindi #50,58469,1620,123,2021-09-04,Sep,80,1743
739,CodeWithHarry,Hashing Passwords using bcryptjs in NodeJs | Complete React Course in Hindi #49,55498,1743,136,2021-09-04,Sep,79,1879
740,CodeWithHarry,Windows 365 Cloud PC: My Opinions Post Release 😢,54460,3132,458,2021-09-03,Sep,48,3590
741,CodeWithHarry,"Understanding Password Hashing, Salt & Pepper | Complete React Course in Hindi #48",53283,2300,178,2021-09-02,Sep,82,2478
742,CodeWithHarry,Creating ThunderClient Collections to Manage Requests | Complete React Course in Hindi #47,57485,1673,173,2021-09-02,Sep,90,1846
743,CodeWithHarry,Adding Data Validation Using express-validator | Complete React Course in Hindi #46,67415,1736,266,2021-09-02,Sep,83,2002
744,CodeWithHarry,Storing Data into the Database Using Mongoose Model | Complete React Course in Hindi #45,90494,2179,572,2021-09-02,Sep,88,2751
745,CodeWithHarry,Creating Routes & Schema for Storing Notes & Users | Complete React Course in Hindi #44,93517,2291,207,2021-09-02,Sep,87,2498
746,CodeWithHarry,iNotebook db & Express Server Setup | Complete React Course in Hindi #43,124221,2540,581,2021-09-02,Sep,72,3121
747,CodeWithHarry,Windows 11 release date announced finally 🔥,129773,6434,737,2021-08-31,Aug,43,7171
748,CodeWithHarry,Project 3: iNotebook backend and React frontend setup | Complete React Course in Hindi #42,128929,3154,257,2021-08-31,Aug,90,3411
749,CodeWithHarry,Introduction to MERN stack | Complete React Course in Hindi #41,166324,4960,440,2021-08-30,Aug,63,5400
750,CodeWithHarry,Sticky Navbar & NewsMonkey bug fixes | Complete React Course in Hindi #40,64734,1877,213,2021-08-29,Aug,73,2090
751,CodeWithHarry,Changing Class based NewsMonkey components to Functional based | Complete React Course in Hindi #39,69773,1968,208,2021-08-29,Aug,99,2176
752,CodeWithHarry,Introduction to React Hooks | Complete React Course in Hindi #38,105319,3019,152,2021-08-29,Aug,64,3171
753,CodeWithHarry,Hiding API Key by Adding Custom Environment Variables | Complete React Course in Hindi #37,66840,2388,262,2021-08-29,Aug,90,2650
754,CodeWithHarry,Adding a top loading bar to NewsMonkey | Complete React Course in Hindi #36,67035,2142,315,2021-08-28,Aug,75,2457
755,CodeWithHarry,Adding Infinite Scroll to NewsMonkey | Complete React Course in Hindi #35,90520,2548,560,2021-08-28,Aug,73,3108
756,CodeWithHarry,React Component Lifecycle & Lifecycle methods  | Complete React Course in Hindi #34,123460,3174,192,2021-08-27,Aug,83,3366
757,CodeWithHarry,Refactoring News component to use the same function  | Complete React Course in Hindi #33,64097,2177,288,2021-08-27,Aug,89,2465
758,CodeWithHarry,"Adding time, author and news source to News React App | Complete React Course in Hindi #32",60862,2036,146,2021-08-27,Aug,90,2182
759,CodeWithHarry,Fetching News category wise in NewsMonkey React App | Complete React Course in Hindi #31,80821,2259,517,2021-08-27,Aug,88,2776
760,CodeWithHarry,Adding Categories & propTypes to NewsMonkey React App | Complete React Course in Hindi #30,81533,2215,131,2021-08-27,Aug,90,2346
761,CodeWithHarry,Adding loading spinner & variable pageSize to NewsMonkey | Complete React Course in Hindi #29,101459,2738,195,2021-08-27,Aug,93,2933
762,CodeWithHarry,Adding Previous & Next Buttons to populate NewsItems | Complete React Course in Hindi #28,120251,2900,347,2021-08-26,Aug,89,3247
763,CodeWithHarry,Using Fetch API in React to populate NewsItems | Complete React Course in Hindi #27,141645,3172,478,2021-08-26,Aug,83,3650
764,CodeWithHarry,Looping through an array in JSX to display NewsItems from state | Complete React Course in Hindi #26,120021,3325,494,2021-08-26,Aug,100,3819
765,CodeWithHarry,Understanding state in class based components  | Complete React Course in Hindi #25,131367,3046,107,2021-08-26,Aug,83,3153
766,CodeWithHarry,Fetching API Key from News API | Complete React Course in Hindi #24,171017,3694,205,2021-08-26,Aug,67,3899
767,CodeWithHarry,Component Structure of our NewsMonkey React App | Complete React Course in Hindi #23,146002,3952,248,2021-08-26,Aug,84,4200
768,CodeWithHarry,Project 2 Setup + Introduction to Class based components | Complete React Course in Hindi #22,158567,4334,277,2021-08-25,Aug,93,4611
769,CodeWithHarry,Fixing few more Textutils Issues | Complete React Course in Hindi #21,74966,2337,220,2021-08-25,Aug,69,2557
770,CodeWithHarry,Exercise 2: Solutions + Shoutouts | Complete React Course in Hindi #20,86681,2235,194,2021-08-24,Aug,70,2429
771,CodeWithHarry,Fixing Issues & Wrapping up TextUtils | Complete React Course in Hindi #19,132172,3312,472,2021-08-24,Aug,74,3784
772,CodeWithHarry,"Should you use HTML, CSS, JavaScript or Frameworks for your next Website?",143964,7166,455,2021-08-23,Aug,73,7621
773,CodeWithHarry,Purchasing a Domain + Hosting TextUtils on a VPS | Complete React Course in Hindi #18,112410,3238,288,2021-08-22,Aug,85,3526
774,CodeWithHarry,[Free] Building + Hosting React App For free on Github Pages | Complete React Course in Hindi #17,215296,4989,520,2021-08-21,Aug,97,5509
775,CodeWithHarry,How much JavaScript is needed to learn React?,499880,19492,742,2021-08-20,Aug,45,20234
776,CodeWithHarry,React Router Setup + Usage | Complete React Course in Hindi #16,284362,5584,1228,2021-08-20,Aug,63,6812
777,CodeWithHarry,React vs Angular - Which one to Learn?,260461,9245,686,2021-08-19,Aug,38,9931
778,CodeWithHarry,Changing title dynamically & adding favicons to TextUtils | Complete React Course in Hindi #15,149701,4088,177,2021-08-19,Aug,94,4265
779,CodeWithHarry,Exercise 2: Adding Custom Color Theme to TextUtils | Complete React Course in Hindi #14,121242,3049,540,2021-08-18,Aug,87,3589
780,CodeWithHarry,Adding + Auto Dismissing Alert Messages | Complete React Course in Hindi #13,214606,5652,1095,2021-08-18,Aug,76,6747
781,CodeWithHarry,Improving Dark Mode & Refactoring App Component | Complete React Course in Hindi #12,271339,6108,670,2021-08-18,Aug,84,6778
782,CodeWithHarry,Exercise 1: Solutions + Shoutouts | Complete React Course in Hindi #11,166879,3984,645,2021-08-18,Aug,70,4629
783,CodeWithHarry,"Creating ""Enable Dark Mode"" Button Using useState Hook  | Complete React Course in Hindi #10",293330,6993,485,2021-08-18,Aug,92,7478
784,CodeWithHarry,Exercise 1: Enhancing TextUtils | Complete React Course in Hindi #9,203358,6174,1998,2021-08-17,Aug,67,8172
785,CodeWithHarry,Adding more Logic to TextUtils | Complete React Course in Hindi #8,268390,7087,448,2021-08-17,Aug,66,7535
786,CodeWithHarry,Understanding State & Handling Events in React | Complete React Course in Hindi #7,490601,10822,713,2021-08-17,Aug,82,11535
787,CodeWithHarry,Understanding Props and PropTypes in React | Complete React Course in Hindi #6,560476,11817,975,2021-08-17,Aug,78,12792
788,CodeWithHarry,Project 1: Setup + Adding Bootstrap to React | Complete React Course in Hindi #5,518183,10838,729,2021-08-16,Aug,80,11567
789,CodeWithHarry,Understanding JSX | Complete React Course in Hindi #4,543172,13137,791,2021-08-16,Aug,53,13928
790,CodeWithHarry,JavaScript Refresher | Complete React Course in Hindi #3,627141,13513,642,2021-08-15,Aug,56,14155
791,CodeWithHarry,Creating our first react app using create-react-app | Complete React Course in Hindi #2,1042196,25578,1619,2021-08-14,Aug,87,27197
792,CodeWithHarry,Introduction to React Js + Installation | Complete React Course in Hindi #1,1985811,48682,7594,2021-08-13,Aug,75,56276
793,CodeWithHarry,php Cheatsheet 🧾 for Beginners 🔥🔥,36712,1595,505,2021-08-06,Aug,33,2100
794,CodeWithHarry,Django Cheatsheet 🧾 for Beginners 🔥🔥,23138,1073,222,2021-08-05,Aug,36,1295
795,CodeWithHarry,Flask Cheatsheet 🧾 for Beginners 🔥🔥,21073,946,212,2021-08-04,Aug,35,1158
796,CodeWithHarry,What does a Software engineer do in a Company? 🔥🔥,1291733,59659,2012,2021-08-02,Aug,49,61671
797,CodeWithHarry,MySQL Cheatsheet 🧾 for Beginners 🔥🔥,128305,4413,451,2021-08-01,Aug,35,4864
798,CodeWithHarry,How much Java to Learn for Android Development? (LEARN THESE TOPICS),297371,13828,1127,2021-07-30,Jul,68,14955
799,CodeWithHarry,Pegasus Spyware WhatsApp Hacking: All you need to know!,795448,31529,2341,2021-07-28,Jul,55,33870
800,CodeWithHarry,Should you use Bootstrap & Tailwind CSS or stick to Vanilla CSS?,113939,5384,505,2021-07-25,Jul,64,5889
801,CodeWithHarry,C++ Cheatsheet 🧾 for Beginners 🔥🔥,62446,2961,469,2021-07-23,Jul,33,3430
802,CodeWithHarry,Software Interview Rejection - How to handle Failure! 🔥🔥,93163,6332,690,2021-07-21,Jul,56,7022
803,CodeWithHarry,Java Cheatsheet 🧾 for Beginners 🔥🔥,59425,3395,502,2021-07-19,Jul,34,3897
804,CodeWithHarry,Perfect Final Year Project Selection Tips & Tricks (Copy These) 🔥🔥,412442,15295,680,2021-07-18,Jul,66,15975
805,CodeWithHarry,C Language Cheatsheet 🧾 for Beginners 🔥,66331,3392,489,2021-07-17,Jul,39,3881
806,CodeWithHarry,Python Cheatsheet 🧾 for Beginners 🔥🔥,100563,4837,533,2021-07-17,Jul,36,5370
807,CodeWithHarry,JavaScript CheatSheet 🧾 for Beginners 🔥,77997,3098,325,2021-07-16,Jul,39,3423
808,CodeWithHarry,CSS CheatSheet 🧾 for beginners 🔥,90055,4054,439,2021-07-16,Jul,32,4493
809,CodeWithHarry,Windows 365: Why I am excited about this Microsoft Offering! 🔥,183008,6548,450,2021-07-16,Jul,62,6998
810,CodeWithHarry,HTML CheatSheet 🧾 for Beginners 🔥,200082,7301,640,2021-07-16,Jul,33,7941
811,CodeWithHarry,Using GitHub Copilot: It will take away your Jobs!,242985,8628,906,2021-07-15,Jul,50,9534
812,CodeWithHarry,Crontab for Linux Admins as fast as possible in Hindi 🔥🔥,116154,4857,536,2021-07-13,Jul,56,5393
813,CodeWithHarry,How to Deploy NodeJs app on Ubuntu in Production,43097,1145,217,2021-07-13,Jul,48,1362
814,CodeWithHarry,3 Habits to Build for Improving Your Logic & Programming Skills (START THESE) 🔥🔥,973388,50288,2271,2021-07-11,Jul,80,52559
815,CodeWithHarry,"Which is ""the best"" Backend Framework to Use for a Project? 🔥🔥",132391,5615,642,2021-07-09,Jul,62,6257
816,CodeWithHarry,How many Programming Languages Should you Learn? (THE TRUTH!),570525,30255,1814,2021-07-07,Jul,61,32069
817,CodeWithHarry,Do You *really* Need a Good Laptop for Coding? (EYE OPENING),892463,45032,2946,2021-07-06,Jul,60,47978
818,CodeWithHarry,"Fastest Way to make ""Money"" From Code! (TRY THIS)",923575,43174,1486,2021-07-04,Jul,49,44660
819,CodeWithHarry,PyMongo Tutorial in Hindi | MongoDb in Python,79795,2616,339,2021-07-04,Jul,45,2955
820,CodeWithHarry,I tried Coding 5 different languages in Windows 11 🔥🔥,61947,3199,488,2021-07-03,Jul,53,3687
821,CodeWithHarry,Express JS Tutorial in Hindi 🔥✌,306758,9592,1030,2021-07-02,Jul,31,10622
822,CodeWithHarry,Top Laptop Models to buy in 2021 ⚡ Watch this before buying a new laptop,388672,16294,2224,2021-07-01,Jul,72,18518
823,CodeWithHarry,First Ever Official Version of Windows 11 is Here! 🔥🔥,959662,26976,1719,2021-06-29,Jun,53,28695
824,CodeWithHarry,What is Deep Learning? (in 5 Minutes) 🔥🔥,187110,10303,892,2021-06-28,Jun,40,11195
825,CodeWithHarry,JSON Tutorial in Hindi 🔥🔥,336626,11077,907,2021-06-28,Jun,25,11984
826,CodeWithHarry,"I Created Windows 11 Using HTML, CSS & JavaScript 🔥🔥",443815,19024,1695,2021-06-26,Jun,52,20719
827,CodeWithHarry,Trying 11 apps on Windows 11 - Lets Go! 🔥🔥,186330,8106,1219,2021-06-26,Jun,42,9325
828,CodeWithHarry,Microsoft Windows 11 Reveal Event in 11 Minutes 🔥🔥,322956,16430,1346,2021-06-25,Jun,50,17776
829,CodeWithHarry,Stock market for beginners - My Investment Strategies revealed 🔥🔥,522902,29859,2420,2021-06-24,Jun,65,32279
830,CodeWithHarry,Perfect Time Table strategy for maximum productivity (This is huge) 🔥🔥,271158,19212,1281,2021-06-23,Jun,70,20493
831,CodeWithHarry,Node Js Tutorial in Hindi 🔥🔥,1268844,32701,3016,2021-06-21,Jun,28,35717
832,CodeWithHarry,How Much To Charge For a Site? 🔥,149883,9848,1109,2021-06-20,Jun,32,10957
833,CodeWithHarry,How much Coding to Learn during School Days?,109832,9359,1854,2021-06-19,Jun,44,11213
834,CodeWithHarry,Windows 11 - I Installed it using VMWare (Have a look!),240242,11478,1261,2021-06-18,Jun,55,12739
835,CodeWithHarry,How to deploy Flask apps on Ubuntu VPS Using gunicorn and Ngnix,24509,817,298,2021-06-17,Jun,63,1115
836,CodeWithHarry,I installed VS Code on Android phone! (See how it performed) 🔥,729591,26769,3141,2021-06-16,Jun,62,29910
837,CodeWithHarry,AVL Trees - LL LR RL and RR rotations,118203,4250,516,2021-06-15,Jun,37,4766
838,CodeWithHarry,What is Apache & Nginx? | Apache vs Nginx 🔥🔥,110676,4341,496,2021-06-15,Jun,44,4837
839,CodeWithHarry,Insertion and Rotation in AVL Tree,104157,3945,311,2021-06-14,Jun,34,4256
840,CodeWithHarry,AVL Trees - Introduction,162718,5222,402,2021-06-13,Jun,24,5624
841,CodeWithHarry,C Code For Deletion in a Binary Search Tree,102959,3390,419,2021-06-13,Jun,43,3809
842,CodeWithHarry,Dark theme vs Light theme - Which one is better?,82200,5505,664,2021-06-12,Jun,48,6169
843,CodeWithHarry,Deletion in a Binary Search Tree,119642,4420,477,2021-06-12,Jun,32,4897
844,CodeWithHarry,What is CI/CD Pipeline? (in Layman's terms),163330,6107,505,2021-06-11,Jun,43,6612
845,CodeWithHarry,"Difference Between Development, Staging, and Prod Environment?",69867,3256,403,2021-06-10,Jun,62,3659
846,CodeWithHarry,These CodePen Blew My Mind 🔥🔥🔥,130787,8143,633,2021-06-10,Jun,30,8776
847,CodeWithHarry,I paid them 5$ to create my website on Fiverr,1002876,33736,1602,2021-06-09,Jun,45,35338
848,CodeWithHarry,One Effective tool to create Readme Files Quickly & Easily,122529,4007,324,2021-06-09,Jun,58,4331
849,CodeWithHarry,How I Beat Procrastination?,304079,22755,1654,2021-06-08,Jun,27,24409
850,CodeWithHarry,VS Code Tricks you might not want to miss 🔥🔥,447907,14973,1233,2021-06-08,Jun,44,16206
851,CodeWithHarry,What is Data Science?,1576227,59302,1473,2021-06-07,Jun,21,60775
852,CodeWithHarry,Install Ubuntu Full GUI Desktop on an Ubuntu VPS,81373,2717,287,2021-06-07,Jun,48,3004
853,CodeWithHarry,A better Postman alternative for VS Code Users,52677,3035,436,2021-06-07,Jun,46,3471
854,CodeWithHarry,What is Machine Learning?,592324,30071,1440,2021-06-06,Jun,25,31511
855,CodeWithHarry,How deploy a Django application using Nginx & Gunicorn in Production,80162,1858,282,2021-06-06,Jun,68,2140
856,CodeWithHarry,MongoDb Tutorial For Beginners in Hindi 🔥🔥,929435,28119,2006,2021-06-05,Jun,42,30125
857,CodeWithHarry,Every freelancer must learn *this* skill!,150927,10681,878,2021-06-04,Jun,41,11559
858,CodeWithHarry,How to install phpMyAdmin on Nginx (in 5 minutes),12831,449,191,2021-06-04,Jun,49,640
859,CodeWithHarry,How to install LEMP stack on Ubuntu VPS?,13079,548,241,2021-06-03,Jun,40,789
860,CodeWithHarry,How to Open Remote Server directly in VS Code (in 2 mins)!,30579,1065,195,2021-06-02,Jun,58,1260
861,CodeWithHarry,How to enable HTTPs on Your Website in 2 minutes?,63459,2386,282,2021-06-02,Jun,49,2668
862,CodeWithHarry,How to install phpMyAdmin on Ubuntu?,25059,868,187,2021-06-01,Jun,36,1055
863,CodeWithHarry,How to Host Multiple Websites on One Server,49666,1722,304,2021-05-31,May,43,2026
864,CodeWithHarry,CSS Grid Tutorial For Beginners in Hindi 🔥🔥,256442,8980,608,2021-05-30,May,43,9588
865,CodeWithHarry,CSS Flexbox Tutorial For Beginners in Hindi 🔥🔥,398247,15357,1048,2021-05-30,May,46,16405
866,CodeWithHarry,"Installing Linux, Apache, MySQL, PHP (LAMP) Stack on Ubuntu 20.04",48328,1654,255,2021-05-30,May,65,1909
867,CodeWithHarry,5 Web Development Tools I Use to Increase Productivity,116232,7761,1120,2021-05-29,May,54,8881
868,CodeWithHarry,Uploading Files & PasswordLess Login on Ubuntu VPS,36554,1909,428,2021-05-28,May,50,2337
869,CodeWithHarry,Configuring a non root user & firewall on a brand new Ubuntu 20.04 server,113091,4342,641,2021-05-27,May,73,4983
870,CodeWithHarry,Use this Frontend Backend combination to become a successful Web Developer!,622783,26991,1655,2021-05-24,May,75,28646
871,CodeWithHarry,Single Page Applications: Why & When to use React/Angular/Vue.js?,291231,12938,2180,2021-05-09,May,65,15118
872,CodeWithHarry,Coding Snake Game In JavaScript,643193,24389,2197,2021-05-05,May,31,26586
873,CodeWithHarry,CSS Tutorial In Hindi (With Notes) 🔥,5244321,114861,15158,2021-04-27,Apr,36,130019
874,CodeWithHarry,React Tutorial in Hindi 🔥🔥,2314734,57287,5445,2021-04-14,Apr,26,62732
875,CodeWithHarry,Angular Tutorial in Hindi,1363631,31184,3461,2021-04-10,Apr,25,34645
876,CodeWithHarry,One Effective Trick to Earn Money From Blogging (Quickly & Easily),115629,6991,810,2021-04-07,Apr,66,7801
877,CodeWithHarry,Reason Why People Fail Learning To Code!,1022781,58246,3207,2021-04-04,Apr,40,61453
878,CodeWithHarry,How To Create Deepfake Videos In 5 Minutes (Hindi),405860,15414,1284,2021-03-28,Mar,50,16698
879,CodeWithHarry,Blogging as Your Next Income Stream - The Complete Guide 🔥,350483,20023,2642,2021-03-21,Mar,58,22665
880,CodeWithHarry,Setup Tour + My Monster Gaming PC Build 🔥,541102,31513,2105,2021-03-19,Mar,41,33618
881,CodeWithHarry,HTML Tutorial For Beginners In Hindi (With Notes) 🔥,9589732,266603,25046,2021-03-17,Mar,51,291649
882,CodeWithHarry,Python Flask Web Development Tutorial in Hindi,583428,14307,2389,2021-03-10,Mar,46,16696
883,CodeWithHarry,Android Development Tutorial For Beginners In Hindi (With Notes) 🔥,4506250,168275,15274,2021-03-07,Mar,66,183549
884,CodeWithHarry,Exercise 7: Solutions + Shoutouts,146388,3584,1180,2021-03-05,Mar,33,4764
885,CodeWithHarry,Advanced Java 2 - Practice Set,79402,1977,338,2021-03-03,Mar,30,2315
886,CodeWithHarry,File Handling in Java,219251,5281,415,2021-03-01,Mar,21,5696
887,CodeWithHarry,Java Generics,140183,3868,257,2021-02-28,Feb,13,4125
888,CodeWithHarry,Java Anonymous Classes & Lambda Expressions,91688,3145,380,2021-02-24,Feb,43,3525
889,CodeWithHarry,Annotations in Java,74126,2605,440,2021-02-21,Feb,19,3045
890,CodeWithHarry,Javadocs: Method Tags For Generating java Documentation,37064,1712,158,2021-02-19,Feb,55,1870
891,CodeWithHarry,Javadocs: Tags for Documenting Classes,42796,2046,172,2021-02-18,Feb,38,2218
892,CodeWithHarry,Generating our own JavaDocs for our Package,50396,2302,287,2021-02-17,Feb,43,2589
893,CodeWithHarry,Java Exercise 7: Library Management System in Java,63155,2028,305,2021-02-15,Feb,50,2333
894,CodeWithHarry,Java Exercise 6: Solution | Custom Calculator,46008,1840,245,2021-02-13,Feb,45,2085
895,CodeWithHarry,Advanced Java Practice Set,74939,2517,225,2021-02-11,Feb,26,2742
896,CodeWithHarry,DateTimeFormatter in Java,57987,2688,184,2021-02-10,Feb,25,2872
897,CodeWithHarry,java.time API - Classes & Methods,57227,3213,828,2021-02-09,Feb,33,4041
898,CodeWithHarry,GregorianCalendar class & TimeZone in java,50955,2737,234,2021-02-08,Feb,42,2971
899,CodeWithHarry,Calendar Class in Java,69916,3066,312,2021-02-06,Feb,22,3378
900,CodeWithHarry,The Date Class in Java,61827,2892,302,2021-02-04,Feb,22,3194
901,CodeWithHarry,Date and Time in Java,86210,3615,437,2021-02-03,Feb,21,4052
902,CodeWithHarry,How Long Should You Code in a Day?,393045,25830,1422,2021-02-02,Feb,34,27252
903,CodeWithHarry,HashSet in Java,93810,3521,190,2021-02-01,Feb,15,3711
904,CodeWithHarry,0 to 1 Million - My Story | About CodeWithHarry 🔥🔥,578023,66621,9469,2021-01-30,Jan,50,76090
905,CodeWithHarry,Hashing in Java,135487,4969,523,2021-01-28,Jan,15,5492
906,CodeWithHarry,These Cool Command Prompt Tricks Will Amaze You!,1147931,48098,2036,2021-01-26,Jan,48,50134
907,CodeWithHarry,Don't Make These Coding Mistakes,140528,10924,871,2021-01-25,Jan,32,11795
908,CodeWithHarry,ArrayDeque in Java,78911,3674,270,2021-01-23,Jan,18,3944
909,CodeWithHarry,"Creating a CheatSheet Template using HTML, CSS & JavaScript",119976,5313,661,2021-01-21,Jan,59,5974
910,CodeWithHarry,10 Amazing Keyboard Shortcuts You Aren't Using!,561589,36854,1961,2021-01-20,Jan,47,38815
911,CodeWithHarry,Complete Roadmap To Learn Machine Learning (PDF Included),647361,30327,1349,2021-01-19,Jan,57,31676
912,CodeWithHarry,Should You Learn jQuery in 2021?,94061,4316,477,2021-01-17,Jan,32,4793
913,CodeWithHarry,5 Hacks to Maximize Your Productivity as a Coder,143683,9354,810,2021-01-15,Jan,48,10164
914,CodeWithHarry,LinkedList in Java: Demo & Methods,136124,4669,377,2021-01-14,Jan,34,5046
915,CodeWithHarry,ArrayList in Java: Demo & Methods,170629,5858,672,2021-01-13,Jan,33,6530
916,CodeWithHarry,How to View Java Documentation (Correct Way),89110,3613,151,2021-01-12,Jan,44,3764
917,CodeWithHarry,Collections Hierarchy in Java,96004,3907,221,2021-01-10,Jan,29,4128
918,CodeWithHarry,Java Collections Framework,184002,5479,249,2021-01-09,Jan,26,5728
919,CodeWithHarry,Java Exercise 6: Custom Calculator | Java Practice Question,54349,2275,331,2021-01-08,Jan,59,2606
920,CodeWithHarry,Practice Set on Errors & Exceptions,67541,2879,304,2021-01-06,Jan,35,3183
921,CodeWithHarry,Finally Block in Java & Why is it needed!,92396,4416,270,2021-01-05,Jan,41,4686
922,CodeWithHarry,Throw vs Throws in Java,168801,6241,267,2021-01-04,Jan,23,6508
923,CodeWithHarry,The Exception class in Java,143496,5189,295,2021-01-03,Jan,27,5484
924,CodeWithHarry,Nested Try-Catch in Java,105467,4695,253,2021-01-02,Jan,24,4948
925,CodeWithHarry,Top 5 Programming Languages To Learn for Jobs,448887,22831,1666,2021-01-01,Jan,45,24497
926,CodeWithHarry,Handling Specific Exceptions in Java,123092,5088,297,2020-12-31,Dec,36,5385
927,CodeWithHarry,Try Catch Block in Java,163575,6549,196,2020-12-30,Dec,23,6745
928,CodeWithHarry,"Syntax Errors, Runtime Errors & Logical Errors in Java (Demo)",123666,5408,236,2020-12-29,Dec,61,5644
929,CodeWithHarry,Errors & Exception in Java,195621,6935,252,2020-12-28,Dec,26,7187
930,CodeWithHarry,Exercise 5: Solution & Shoutouts!,62427,2513,193,2020-12-26,Dec,33,2706
931,CodeWithHarry,Java Tutorial: Practice Questions on Thread,82415,3485,228,2020-12-24,Dec,43,3713
932,CodeWithHarry,Java Thread Methods,114714,4754,193,2020-12-23,Dec,19,4947
933,CodeWithHarry,5 Android Projects to Start This Weekend!,75540,3730,506,2020-12-22,Dec,41,4236
934,CodeWithHarry,Java Thread Priorities,114620,4835,207,2020-12-21,Dec,22,5042
935,CodeWithHarry,Insertion in a Binary Search Tree,163469,5197,541,2020-12-21,Dec,33,5738
936,CodeWithHarry,Constructors from Thread class in Java,129062,5125,264,2020-12-20,Dec,38,5389
937,CodeWithHarry,Iterative Search in a Binary Search Tree,73039,2835,134,2020-12-20,Dec,40,2969
938,CodeWithHarry,C Code For Searching in a BST,84934,2984,154,2020-12-19,Dec,29,3138
939,CodeWithHarry,Searching in a Binary Search Trees (Search Operation),111716,4141,160,2020-12-18,Dec,53,4301
940,CodeWithHarry,Checking if a binary tree is a binary search tree or not!,133126,4087,279,2020-12-17,Dec,57,4366
941,CodeWithHarry,Binary Search Trees: Introduction & Properties,177485,6466,516,2020-12-16,Dec,46,6982
942,CodeWithHarry,5 Machine Learning Projects To Start This Weekend!,151401,6102,583,2020-12-15,Dec,50,6685
943,CodeWithHarry,"*Best* Trick To Find PreOrder, InOrder & PostOrder Traversal",110553,5596,342,2020-12-14,Dec,60,5938
944,CodeWithHarry,InOrder Traversal in a Binary Tree (With C Code),95926,3554,210,2020-12-12,Dec,48,3764
945,CodeWithHarry,PostOrder Traversal in a Binary Tree (With C Code),94631,3511,135,2020-12-12,Dec,50,3646
946,CodeWithHarry,Preorder Traversal in a Binary Tree (With C Code),138465,4479,166,2020-12-12,Dec,49,4645
947,CodeWithHarry,"Traversal in Binary Tree (InOrder, PostOrder and PreOrder Traversals)",167981,5608,369,2020-12-11,Dec,69,5977
948,CodeWithHarry,Linked Representation Of Binary Tree in C,155586,5164,211,2020-12-10,Dec,41,5375
949,CodeWithHarry,Representation of a Binary Tree,169362,6223,246,2020-12-10,Dec,31,6469
950,CodeWithHarry,Types of Binary Trees,174207,6436,249,2020-12-09,Dec,21,6685
951,CodeWithHarry,How I Learned to Type Really Fast (150 Words/Minute),3581973,139384,4402,2020-12-07,Dec,52,143786
952,CodeWithHarry,Java Thread Life Cycle,153669,6164,277,2020-12-06,Dec,22,6441
953,CodeWithHarry,What is a Binary Tree?,206651,6952,416,2020-12-05,Dec,22,7368
954,CodeWithHarry,Introduction to Trees,284328,8846,552,2020-12-04,Dec,21,9398
955,CodeWithHarry,Creating a Java Thread Using Runnable Interface,162644,6334,339,2020-12-04,Dec,47,6673
956,CodeWithHarry,Creating a Thread by Extending Thread class,227802,7435,641,2020-12-03,Dec,43,8076
957,CodeWithHarry,Multithreading in Java,371588,10324,257,2020-12-03,Dec,22,10581
958,CodeWithHarry,How to Speed Up Your Windows 10 Performance (Best Settings),584084,24743,1464,2020-12-01,Dec,59,26207
959,CodeWithHarry,Java Exercise 5: Creating a Custom Package,76318,2753,274,2020-12-01,Dec,42,3027
960,CodeWithHarry,What is an API?,1464021,49074,1911,2020-11-30,Nov,15,50985
961,CodeWithHarry,5 Quick Web Development Projects To Finish This Weekend!,191747,8894,671,2020-11-29,Nov,56,9565
962,CodeWithHarry,Practice Set on Java Package & Access Modifiers,91559,3668,333,2020-11-28,Nov,47,4001
963,CodeWithHarry,5 Quick Python Projects to Add To Your Resume!,539647,22558,1063,2020-11-27,Nov,46,23621
964,CodeWithHarry,How Much Maths is Needed for Programming?,397987,22097,3158,2020-11-26,Nov,41,25255
965,CodeWithHarry,Access Modifiers in Java,224158,6979,335,2020-11-25,Nov,24,7314
966,CodeWithHarry,Rs 10000 PC Build For Coders,784311,23302,1654,2020-11-24,Nov,28,24956
967,CodeWithHarry,Java Tutorial: Creating Packages in Java,219587,7978,1120,2020-11-24,Nov,40,9098
968,CodeWithHarry,Packages in Java,265187,8226,337,2020-11-23,Nov,16,8563
969,CodeWithHarry,Is Java interpreted or compiled?,113419,5757,235,2020-11-22,Nov,32,5992
970,CodeWithHarry,Interpreted vs Compiled Languages!,161033,7930,399,2020-11-21,Nov,34,8329
971,CodeWithHarry,Java Exercise 4: Solution & Shoutouts!,97638,3701,273,2020-11-20,Nov,38,3974
972,CodeWithHarry,Java Practice Questions on Abstract Classes & Interfaces,119299,4856,254,2020-11-19,Nov,56,5110
973,CodeWithHarry,Java Tutorial: Polymorphism in Interfaces,177991,7440,394,2020-11-18,Nov,41,7834
974,CodeWithHarry,Data Structures & Algorithms: Which Programming Language to Use?,377640,16610,632,2020-11-18,Nov,64,17242
975,CodeWithHarry,Laptop vs Desktop: Which One to Buy?,159722,9706,1077,2020-11-17,Nov,36,10783
976,CodeWithHarry,Inheritance in Interfaces,132360,6212,182,2020-11-17,Nov,25,6394
977,CodeWithHarry,Java Interfaces Example & Default Methods,164325,7081,429,2020-11-16,Nov,41,7510
978,CodeWithHarry,Why multiple inheritance is not supported in java?,172286,7284,224,2020-11-15,Nov,50,7508
979,CodeWithHarry,Java Tutorial: Abstract Classes Vs Interfaces,242868,9384,370,2020-11-13,Nov,45,9754
980,CodeWithHarry,Java Tutorial: Introduction to Interfaces,322052,10960,1337,2020-11-12,Nov,41,12297
981,CodeWithHarry,Java Tutorial: Abstract Class & Abstract Methods,375879,12210,1474,2020-11-11,Nov,48,13684
982,CodeWithHarry,Java Tutorial: Exercise & Practice Questions on Inheritance,157858,5697,431,2020-11-10,Nov,59,6128
983,CodeWithHarry,Java Tutorial: Exercise 4 - Online Library,126807,4435,560,2020-11-09,Nov,42,4995
984,CodeWithHarry,"Best Rs 20,000 Budget Gaming PC Build - Step by Step 🔥🔥",761593,31962,2535,2020-11-08,Nov,55,34497
985,CodeWithHarry,Java Tutorial: Exercise 3 - Solutions & Shoutouts,151135,5099,444,2020-11-04,Nov,49,5543
986,CodeWithHarry,Count Sort Algorithm,86797,3591,579,2020-11-03,Nov,20,4170
987,CodeWithHarry,Dynamic Method Dispatch in Java,241374,9960,567,2020-11-02,Nov,31,10527
988,CodeWithHarry,Method Overriding in Java,264790,11224,495,2020-11-01,Nov,25,11719
989,CodeWithHarry,"Killer Responsive Blog Template Step By Step From Scratch (Pure HTML, CSS & JavaScript)",430870,12018,772,2020-10-30,Oct,87,12790
990,CodeWithHarry,this and super keyword in Java,282937,9871,321,2020-10-29,Oct,30,10192
991,CodeWithHarry,MergeSort Source Code in C (Helpful Explanation),135102,4309,301,2020-10-28,Oct,48,4610
992,CodeWithHarry,Constructors in Inheritance in Java,270485,11211,830,2020-10-27,Oct,35,12041
993,CodeWithHarry,Inheritance in Java,420837,14097,1070,2020-10-26,Oct,19,15167
994,CodeWithHarry,MergeSort Sorting Algorithm in Hindi,219291,6622,336,2020-10-25,Oct,36,6958
995,CodeWithHarry,Analysis of QuickSort Sorting Algorithm,66328,2911,220,2020-10-24,Oct,39,3131
996,CodeWithHarry,QuickSort Algorithm in Hindi (With Code in C),259463,7611,585,2020-10-23,Oct,45,8196
997,CodeWithHarry,Selection Sort Program in C,138790,4726,471,2020-10-22,Oct,27,5197
998,CodeWithHarry,Selection Sort Algorithm,181783,6923,330,2020-10-22,Oct,24,7253
999,CodeWithHarry,Insertion Sort in C Language (With Explanation),154626,5600,369,2020-10-21,Oct,47,5969
1000,CodeWithHarry,Insertion Sort Algorithm in Hindi,227963,9388,616,2020-10-21,Oct,33,10004
1001,CodeWithHarry,Bubble Sort Program in C,224320,6957,390,2020-10-20,Oct,24,7347
1002,CodeWithHarry,Bubble Sort Algorithm in Hindi,247163,9976,703,2020-10-20,Oct,30,10679
1003,CodeWithHarry,Criteria For Analysis of Sorting Algorithms,98552,5044,226,2020-10-19,Oct,43,5270
1004,CodeWithHarry,Introduction to Sorting Algorithms,203963,8066,267,2020-10-19,Oct,34,8333
1005,CodeWithHarry,Java Tutorial: Exercise on Access Modifiers and Constructors,217202,7218,311,2020-10-18,Oct,60,7529
1006,CodeWithHarry,Java Exercise 3: Guess the Number (OOPs Edition),196065,6669,922,2020-10-18,Oct,48,7591
1007,CodeWithHarry,Java Tutorial: Constructors in Java,467327,15341,662,2020-10-18,Oct,35,16003
1008,CodeWithHarry,Java Tutorial: Exercise 2 - Solution and Shoutouts,210957,6749,268,2020-10-17,Oct,50,7017
1009,CodeWithHarry,How to Become a Full Stack Web Developer | Complete Roadmap,1624464,97473,3131,2020-10-16,Oct,59,100604
1010,CodeWithHarry,"Java Tutorial: Access modifiers, getters & setters in Java",442219,15945,498,2020-10-15,Oct,58,16443
1011,CodeWithHarry,Java Tutorial: Basic Questions on Object Oriented Programming,324686,10561,418,2020-10-15,Oct,61,10979
1012,CodeWithHarry,Java Tutorial: Creating Our Own Java Class,412694,15295,397,2020-10-14,Oct,42,15692
1013,CodeWithHarry,Function Objects (Functors) In C++ STL | C++ Tutorials for Beginners #74,163692,8005,1155,2020-10-14,Oct,72,9160
1014,CodeWithHarry,Map In C++ STL | C++ Tutorials for Beginners #73,186002,6120,271,2020-10-14,Oct,48,6391
1015,CodeWithHarry,Java Tutorial: Basic Terminologies in Object Oriented Programming,377914,17864,475,2020-10-13,Oct,65,18339
1016,CodeWithHarry,How to become an Android developer | Complete Roadmap,764715,36793,2271,2020-10-12,Oct,53,39064
1017,CodeWithHarry,Java Tutorial: Introduction to Object Oriented Programming,607390,21408,893,2020-10-11,Oct,58,22301
1018,CodeWithHarry,Double-Ended Queue in Data Structure (DE-Queue Explained)🔥,113474,5252,544,2020-10-10,Oct,58,5796
1019,CodeWithHarry,Java Tutorial: Practice Questions on Java Methods,296662,9346,1050,2020-10-09,Oct,49,10396
1020,CodeWithHarry,Java Tutorial: Recursion in Java,344373,12671,566,2020-10-08,Oct,32,13237
1021,CodeWithHarry,Java Tutorial: Variable Arguments (VarArgs) in Java,310253,12987,744,2020-10-08,Oct,51,13731
1022,CodeWithHarry,Java Tutorial: Method Overloading in Java,475234,18821,1619,2020-10-08,Oct,41,20440
1023,CodeWithHarry,Java Tutorial: Methods in Java,665027,21028,798,2020-10-07,Oct,30,21826
1024,CodeWithHarry,How to Make IntelliJ IDEA look Amazing!,262826,8199,428,2020-10-07,Oct,39,8627
1025,CodeWithHarry,Java Tutorial: Practice Questions on Arrays in Java,545529,16410,1661,2020-10-06,Oct,51,18071
1026,CodeWithHarry,Java Tutorial: Multidimensional Arrays in Java,419943,21540,533,2020-10-06,Oct,46,22073
1027,CodeWithHarry,Java Tutorial: For Each Loop in Java,427493,20517,655,2020-10-05,Oct,36,21172
1028,CodeWithHarry,Java Tutorial: Introduction to Arrays,600934,23971,576,2020-10-04,Oct,37,24547
1029,CodeWithHarry,Java tutorial: Practice Questions on Loops,378938,13334,1207,2020-10-03,Oct,42,14541
1030,CodeWithHarry,Implementing Queue Using Linked List in C Language (With Code),71618,2855,200,2020-10-02,Oct,62,3055
1031,CodeWithHarry,Java Tutorial: break and continue in Java,322457,15364,347,2020-10-02,Oct,41,15711
1032,CodeWithHarry,Queue Using Linked Lists,95582,4320,270,2020-10-02,Oct,24,4590
1033,CodeWithHarry,Java Tutorial: The for Loop in Java,428715,19639,1158,2020-10-01,Oct,35,20797
1034,CodeWithHarry,C Code For Circular Queue & Operations on Circular Queue in Hindi,81163,4413,298,2020-09-30,Sep,65,4711
1035,CodeWithHarry,"enqueue(), dequeue() & other Operations on Circular Queue",107278,5874,734,2020-09-29,Sep,57,6608
1036,CodeWithHarry,Introduction to Circular Queue in Data Structures,191795,8590,1233,2020-09-29,Sep,49,9823
1037,CodeWithHarry,Java Tutorial: The do-while loop in Java,313347,23862,1762,2020-09-29,Sep,40,25624
1038,CodeWithHarry,Java Tutorial: While Loops in Java,440426,28420,828,2020-09-28,Sep,34,29248
1039,CodeWithHarry,List In C++ STL | C++ Tutorials for Beginners #72,145529,7399,579,2020-09-27,Sep,49,7978
1040,CodeWithHarry,Python Programming Course in Hindi (Advanced) 🔥,1135256,35060,3962,2020-09-25,Sep,47,39022
1041,CodeWithHarry,Python Tutorial For Beginners In Hindi (With Notes) 🔥,21829903,604047,119953,2020-09-24,Sep,53,724000
1042,CodeWithHarry,Complete Roadmap to Become a Data Scientist,1468818,80247,4059,2020-09-23,Sep,43,84306
1043,CodeWithHarry,Vector In C++ STL | C++ Tutorials for Beginners #71,343537,10905,413,2020-09-23,Sep,51,11318
1044,CodeWithHarry,Containers in C++ STL | C++ Tutorials for Beginners #70,139858,6804,296,2020-09-22,Sep,55,7100
1045,CodeWithHarry,"Java Programming Exercise 2: Rock, Paper Scissors Game in Java",325185,14368,2270,2020-09-21,Sep,62,16638
1046,CodeWithHarry,Java Tutorial: Practice Questions On Conditionals & Switch Case,477899,17201,3304,2020-09-20,Sep,63,20505
1047,CodeWithHarry,Java Tutorial: Switch Case Statements in Java,541781,26500,836,2020-09-18,Sep,45,27336
1048,CodeWithHarry,Java Tutorial: Relational and Logical Operators in Java,386326,24303,549,2020-09-17,Sep,55,24852
1049,CodeWithHarry,Java Conditionals: If-else Statement in Java,555686,29134,721,2020-09-16,Sep,44,29855
1050,CodeWithHarry,C Code For Queue and its Operations Using Arrays in Data Structure,128266,5754,446,2020-09-15,Sep,66,6200
1051,CodeWithHarry,Array implementation of Queue and its Operations in Data Structure,126558,5854,245,2020-09-14,Sep,66,6099
1052,CodeWithHarry,Java Practice Questions on Strings: Practice Set on Java Strings (Must Solve!),444631,25453,1273,2020-09-14,Sep,78,26726
1053,CodeWithHarry,Java Tutorial: String Methods in Java,875883,40279,1058,2020-09-14,Sep,37,41337
1054,CodeWithHarry,Queue Implementation: Array Implementation of Queue in Data Structure,188373,7665,251,2020-09-13,Sep,69,7916
1055,CodeWithHarry,Java Tutorial: Introduction to Strings,697539,24607,647,2020-09-13,Sep,38,25254
1056,CodeWithHarry,Java Tutorial: Chapter 2 - Practice Set (Java Practice Questions),519936,25282,2451,2020-09-12,Sep,65,27733
1057,CodeWithHarry,Working with PDF files in Python | How to extract text from Pdf using Python?,97906,2368,338,2020-09-12,Sep,77,2706
1058,CodeWithHarry,The C++ Standard Template Library (STL) | C++ Tutorials for Beginners #69,185039,8130,245,2020-09-12,Sep,73,8375
1059,CodeWithHarry,Member Function Templates & Overloading Template Functions in C++ | C++ Tutorials for Beginners #68,82915,4381,110,2020-09-11,Sep,99,4491
1060,CodeWithHarry,Python Program to Multiply Two Matrices,47071,1007,103,2020-09-11,Sep,39,1110
1061,CodeWithHarry,Java Tutorial: Exercise 1 - Solutions + Shoutouts,468074,15655,1042,2020-09-11,Sep,49,16697
1062,CodeWithHarry,Queue Data Structure in Hindi,268138,13989,234,2020-09-11,Sep,29,14223
1063,CodeWithHarry,C++ Function Templates & Function Templates with Parameters | C++ Tutorials for Beginners #67,96138,4488,193,2020-09-11,Sep,93,4681
1064,CodeWithHarry,HCF/GCD of Two numbers Using Python,48900,1518,226,2020-09-11,Sep,35,1744
1065,CodeWithHarry,C++ Templates: Class Templates with Default Parameters | C++ Tutorials for Beginners #66,80071,6471,176,2020-09-10,Sep,88,6647
1066,CodeWithHarry,Java Tutorial:  Data Type of Expressions & Increment/Decrement Operators,636798,31339,905,2020-09-10,Sep,72,32244
1067,CodeWithHarry,Tricks to Buy the Best Laptop | Which Laptop Should you Buy for Coding in College?,1574971,67208,4900,2020-09-09,Sep,82,72108
1068,CodeWithHarry,C++ Templates: Templates with Multiple Parameters | C++ Tutorials for Beginners #65,95165,5396,193,2020-09-09,Sep,83,5589
1069,CodeWithHarry,Calculate LCM Of Two Numbers in Python | Python Program For Finding LCM of 2 Numbers,26721,1110,161,2020-09-08,Sep,84,1271
1070,CodeWithHarry,Writing our First C++ Template in VS Code | C++ Tutorials for Beginners #64,154364,7519,400,2020-09-08,Sep,75,7919
1071,CodeWithHarry,Java Tutorial: Associativity of Operators in Java,669887,37511,966,2020-09-08,Sep,49,38477
1072,CodeWithHarry,C++ Templates: Must for Competitive Programming | C++ Tutorials for Beginners #63,241456,8798,603,2020-09-07,Sep,81,9401
1073,CodeWithHarry,"Java Tutorial: Operators, Types of Operators & Expressions in Java",879322,37684,935,2020-09-07,Sep,66,38619
1074,CodeWithHarry,Coding Infix to Postfix in C using Stack,171740,6367,360,2020-09-07,Sep,40,6727
1075,CodeWithHarry,File I/O in C++: open() and eof() functions | C++ Tutorials for Beginners #62,113037,6995,146,2020-09-06,Sep,77,7141
1076,CodeWithHarry,File I/O in C++: Read/Write in the  Same Program & Closing Files | C++ Tutorials for Beginners #61,132884,6394,202,2020-09-06,Sep,98,6596
1077,CodeWithHarry,Python Program to Add Two Matrices,48503,1512,141,2020-09-06,Sep,34,1653
1078,CodeWithHarry,Java Tutorial: Chapter 1- Practice Set | Java Practice Problems With Solution,929379,32177,1815,2020-09-05,Sep,77,33992
1079,CodeWithHarry,Infix To Postfix Using Stack,211715,10672,429,2020-09-05,Sep,28,11101
1080,CodeWithHarry,"Infix, Prefix and Postfix Expressions",356496,12090,966,2020-09-04,Sep,37,13056
1081,CodeWithHarry,Java Programming Exercise 1: CBSE Board Percentage Calculator,823772,21279,5507,2020-09-04,Sep,61,26786
1082,CodeWithHarry,Java Tutorial: Getting User Input in Java,1438877,44004,1618,2020-09-03,Sep,41,45622
1083,CodeWithHarry,Multiple Parenthesis Matching Using Stack with C Code,76982,3610,217,2020-09-03,Sep,53,3827
1084,CodeWithHarry,Java Tutorial: Literals in Java,1309845,64199,4298,2020-09-02,Sep,31,68497
1085,CodeWithHarry,Parenthesis Checking Using Stack in C Language,105367,4961,317,2020-09-02,Sep,46,5278
1086,CodeWithHarry,Java Tutorial: Variables and Data Types in Java Programming,1949390,91442,7184,2020-09-01,Sep,59,98626
1087,CodeWithHarry,Parenthesis Matching Problem Using Stack Data Structure (Applications of Stack),113911,5030,601,2020-09-01,Sep,79,5631
1088,CodeWithHarry,Basic Structure of a Java Program: Understanding our First Java Hello World Program,2436186,97574,14077,2020-08-31,Aug,83,111651
1089,CodeWithHarry,"peek(), stackTop() and Other Operations on Stack Using Linked List (with C Code)",79078,3735,368,2020-08-31,Aug,80,4103
1090,CodeWithHarry,Introduction to Java + Installing Java JDK and IntelliJ IDEA for Java,6123229,124700,18067,2020-08-30,Aug,69,142767
1091,CodeWithHarry,C Program to Calculate Power of a Number,52761,1752,205,2020-08-30,Aug,40,1957
1092,CodeWithHarry,Implementing all the Stack Operations using Linked List (With Code in C),154827,6079,345,2020-08-30,Aug,72,6424
1093,CodeWithHarry,How to Implement Stack Using Linked List?,168242,5812,226,2020-08-29,Aug,41,6038
1094,CodeWithHarry,5 Effective Ways to Make Money Online (More Than Jobs),645372,46252,5023,2020-08-28,Aug,54,51275
1095,CodeWithHarry,"stackTop, stackBottom & Time Complexity of Operations in Stack Using Arrays",88443,5322,582,2020-08-27,Aug,75,5904
1096,CodeWithHarry,Peek Operation in Stack Using Arrays (With C Code & Explanation),125709,5903,787,2020-08-27,Aug,64,6690
1097,CodeWithHarry,"Coding Push(), Pop(), isEmpty() and isFull() Operations in Stack Using an Array| C Code For Stack",177548,6862,613,2020-08-26,Aug,97,7475
1098,CodeWithHarry,"Push, Pop and Other Operations in Stack Implemented Using an Array",205255,9099,804,2020-08-26,Aug,66,9903
1099,CodeWithHarry,C Code For Implementing Stack Using Array in Data Structures,257422,7993,761,2020-08-26,Aug,60,8754
1100,CodeWithHarry,C Program to Count Number of Digits in an Integer,40510,1403,295,2020-08-25,Aug,49,1698
1101,CodeWithHarry,Implementing Stack Using Array in Data Structures,305918,8830,306,2020-08-25,Aug,49,9136
1102,CodeWithHarry,Solving the Problem given to Nathan from the Movie X+Y in Python,25954,1178,178,2020-08-24,Aug,64,1356
1103,CodeWithHarry,Introduction to Stack in Data Structures,464375,15737,564,2020-08-24,Aug,40,16301
1104,CodeWithHarry,C Program To Print Star Pattern - 5,22172,850,149,2020-08-23,Aug,35,999
1105,CodeWithHarry,"I Created an Action Game in Pure HTML, CSS & JavaScript - Game Development Tutorial in Hindi",359197,10114,1321,2020-08-22,Aug,92,11435
1106,CodeWithHarry,Python Program to Print nth term of Fibonacci Series: Iterative vs Recursive approach,49765,1329,155,2020-08-21,Aug,85,1484
1107,CodeWithHarry,Doubly Linked Lists Explained With Code in C Language,202929,7366,562,2020-08-21,Aug,53,7928
1108,CodeWithHarry,C Program To Print Number Pattern - 1,21801,815,129,2020-08-20,Aug,37,944
1109,CodeWithHarry,Circular Linked Lists: Operations in C Language,182867,6777,371,2020-08-20,Aug,47,7148
1110,CodeWithHarry,C Program To Print Star Pattern - 4,21791,970,253,2020-08-19,Aug,35,1223
1111,CodeWithHarry,"Moving Lamborghini Car Animation Using Pure HTML, CSS & JavaScript 🔥🔥",283658,9351,809,2020-08-18,Aug,69,10160
1112,CodeWithHarry,Circular Linked List and Operations in Data Structures (With Notes),235657,9791,1094,2020-08-18,Aug,67,10885
1113,CodeWithHarry,C Program To Print Star Pattern - 3,40713,1446,180,2020-08-17,Aug,35,1626
1114,CodeWithHarry,Creating a Rest API Using Flask and Jsonify in Python,172130,4062,373,2020-08-17,Aug,53,4435
1115,CodeWithHarry,"I Created an Analog Clock Using Pure HTML, CSS and JavaScript",365658,11025,1226,2020-08-16,Aug,61,12251
1116,CodeWithHarry,"Delete a Node from Linked List (C Code For Deletion From Beginning, End, Specified Position & Key)",213923,7800,413,2020-08-16,Aug,98,8213
1117,CodeWithHarry,C Program To Print Star Pattern - 2,51194,1843,163,2020-08-15,Aug,35,2006
1118,CodeWithHarry,Deletion in a Linked List | Deleting a node from Linked List Data Structure,246625,8165,239,2020-08-15,Aug,75,8404
1119,CodeWithHarry,C Program To Print Prime Numbers In A Given Range,89568,2363,262,2020-08-14,Aug,49,2625
1120,CodeWithHarry,Insertion in a Linked List in C Language,398819,9927,555,2020-08-14,Aug,40,10482
1121,CodeWithHarry,C Program to Reverse a String,61239,1535,150,2020-08-13,Aug,29,1685
1122,CodeWithHarry,Insertion of a Node in a Linked List Data Structure,455803,12492,686,2020-08-13,Aug,51,13178
1123,CodeWithHarry,Python Program to Check Armstrong Number,66129,1990,252,2020-08-12,Aug,40,2242
1124,CodeWithHarry,Linked List Data Structure: Creation and Traversal in C Language,689189,18639,686,2020-08-12,Aug,64,19325
1125,CodeWithHarry,C Program to Print Star Pattern - 1,141185,4263,347,2020-08-11,Aug,35,4610
1126,CodeWithHarry,Introduction to Linked List in Data Structures (With Notes),869085,27330,773,2020-08-11,Aug,59,28103
1127,CodeWithHarry,C Program to Calculate Factorial of a Number,55917,1683,197,2020-08-10,Aug,44,1880
1128,CodeWithHarry,Linear Vs Binary Search + Code in C Language (With Notes),475259,13981,771,2020-08-10,Aug,57,14752
1129,CodeWithHarry,C Program to Reverse a Number,67358,2364,308,2020-08-09,Aug,29,2672
1130,CodeWithHarry,Coding Deletion Operation in Array Using C Language (With Notes),212281,7307,382,2020-08-09,Aug,64,7689
1131,CodeWithHarry,I Created a Binod Detector In Python 🔥🔥,81435,5388,4936,2020-08-08,Aug,39,10324
1132,CodeWithHarry,Coding Insertion Operation in Array in Data Structures in C language,357922,9257,508,2020-08-08,Aug,68,9765
1133,CodeWithHarry,C Program to Find Prime Number,105751,3002,338,2020-08-07,Aug,30,3340
1134,CodeWithHarry,"Operations on Arrays in Data Structures: Traversal, Insertion, Deletion and Searching",492394,14551,1105,2020-08-07,Aug,85,15656
1135,CodeWithHarry,C Program to Find Largest Element in an Array,81263,2037,215,2020-08-06,Aug,45,2252
1136,CodeWithHarry,Implementing Array as an Abstract Data Type in C Language,385372,11218,759,2020-08-06,Aug,57,11977
1137,CodeWithHarry,C Program to Convert Decimal Number to Binary Number,103594,2979,383,2020-08-05,Aug,52,3362
1138,CodeWithHarry,Array as An Abstract Data Type in Data Structures(With Notes),395765,16851,447,2020-08-05,Aug,61,17298
1139,CodeWithHarry,C Program to Find Sum Of First n Natural Numbers in O(1),62929,2074,207,2020-08-04,Aug,56,2281
1140,CodeWithHarry,Arrays and Abstract Data Type in Data Structure (With Notes),632563,20453,613,2020-08-04,Aug,60,21066
1141,CodeWithHarry,C Program to Generate Multiplication Table of a Given Number,220580,5782,592,2020-08-03,Aug,60,6374
1142,CodeWithHarry,How to Calculate Time Complexity of an Algorithm + Solved Questions (With Notes),822099,25341,973,2020-08-03,Aug,80,26314
1143,CodeWithHarry,"Best Case, Worst Case and Average Case Analysis of an Algorithm (With Notes)",599633,24916,1360,2020-08-02,Aug,76,26276
1144,CodeWithHarry,"Asymptotic Notations: Big O, Big Omega and Big Theta Explained (With Notes)",887318,31913,1120,2020-08-01,Aug,75,33033
1145,CodeWithHarry,Time Complexity and Big O Notation (with notes),1464665,48496,1827,2020-07-31,Jul,47,50323
1146,CodeWithHarry,Introduction to Data Structures & Algorithms,4190503,106182,5315,2020-07-30,Jul,44,111497
1147,CodeWithHarry,I Coded 5 Languages on this 3000 ₹ Computer - Can Programmers code using Raspberry Pi 4?,278220,11773,1563,2020-07-29,Jul,88,13336
1148,CodeWithHarry,C Language Tutorial For Beginners In Hindi (With Notes) 🔥,16055580,391274,73785,2020-07-28,Jul,57,465059
1149,CodeWithHarry,Everyone Should Learn This Programming Language🔥🔥,98603,11885,3452,2020-07-25,Jul,49,15337
1150,CodeWithHarry,File I/O in C++: Reading and Writing Files | C++ Tutorials for Beginners #60,243858,8429,376,2020-07-24,Jul,76,8805
1151,CodeWithHarry,5 Effective Tips to learn Python fast!,975208,52343,2716,2020-07-22,Jul,38,55059
1152,CodeWithHarry,J.A.R.V.I.S Desktop Assistant Project Summary - in 5 minutes!,85878,5075,798,2020-07-21,Jul,61,5873
1153,CodeWithHarry,File I/O in C++: Working with Files | C++ Tutorials for Beginners #59,213483,8271,1154,2020-07-20,Jul,69,9425
1154,CodeWithHarry,Should You Learn C++?,528919,27063,1845,2020-07-19,Jul,21,28908
1155,CodeWithHarry,Abstract Base Class & Pure Virtual Functions in C++ | C++ Tutorials for Beginners #58,156715,8508,296,2020-07-18,Jul,85,8804
1156,CodeWithHarry,Which Python Version To Use While Learning Python?,23296,1406,452,2020-07-17,Jul,50,1858
1157,CodeWithHarry,Virtual Functions Example + Creation Rules in C++ | C++ Tutorials for Beginners #57,146990,7051,822,2020-07-15,Jul,83,7873
1158,CodeWithHarry,JupyterLab Tutorial🔥🔥,33398,1246,304,2020-07-14,Jul,21,1550
1159,CodeWithHarry,5 Best IDEs to use - Which one to use when?,315013,12970,1612,2020-07-13,Jul,43,14582
1160,CodeWithHarry,Using protected Access Modifier in PHP Inheritance | PHP Tutorial #82,30790,1476,320,2020-07-12,Jul,69,1796
1161,CodeWithHarry,Virtual Functions in C++ | C++ Tutorials for Beginners #56,257466,7833,352,2020-07-11,Jul,58,8185
1162,CodeWithHarry,Pointers to Derived Classes in C++ | C++ Tutorials for Beginners #55,165700,6475,497,2020-07-10,Jul,68,6972
1163,CodeWithHarry,Polymorphism in C++ | C++ Tutorials for Beginners #54,257628,9363,413,2020-07-09,Jul,53,9776
1164,CodeWithHarry,One Effective Trick to Learn Coding Fast,2004709,118513,4489,2020-07-07,Jul,40,123002
1165,CodeWithHarry,Inheritance in PHP: A Helpful & Illustrative Guide | PHP Tutorial #81,21904,870,173,2020-07-06,Jul,69,1043
1166,CodeWithHarry,Access Modifiers in Php | PHP Tutorial #80,19664,872,119,2020-07-05,Jul,42,991
1167,CodeWithHarry,__destruct() function in Php | PHP Tutorial #79,17265,812,232,2020-07-04,Jul,47,1044
1168,CodeWithHarry,PHP Constructor: Understanding __construct() function in Php | PHP Tutorial #78,27237,1087,177,2020-07-03,Jul,79,1264
1169,CodeWithHarry,Understanding Classes and Objects Using GTA Vice City and PubG | PHP Tutorial #77,63757,2481,288,2020-07-01,Jul,81,2769
1170,CodeWithHarry,Introduction to Object Oriented Programming in PHP | PHP Tutorial #76,69252,1883,233,2020-06-30,Jun,69,2116
1171,CodeWithHarry,Hosting Multiple php Websites on a Single 5$ Server | PHP Tutorial #75,16555,860,274,2020-06-29,Jun,70,1134
1172,CodeWithHarry,Automating Filezilla FTP Client login | PHP Tutorial #74,11648,461,101,2020-06-28,Jun,56,562
1173,CodeWithHarry,Installing Filezilla FTP Client for Transferring Files to the server | PHP Tutorial #73,64865,1178,219,2020-06-26,Jun,87,1397
1174,CodeWithHarry,Installing phpMyAdmin for Setting Up Database on a Remote Server | PHP Tutorial #72,16027,618,145,2020-06-25,Jun,83,763
1175,CodeWithHarry,Installing Apache2 & MySQL on Ubuntu for PHP Hosting | PHP Tutorial #71,21529,1014,206,2020-06-24,Jun,71,1220
1176,CodeWithHarry,"Whats new in Bootstrap 5? Preview, Features & Impact! 🔥🔥",63983,4041,1894,2020-06-23,Jun,56,5935
1177,CodeWithHarry,Managing Multiple Virtual Private Servers for PHP Hosting | PHP Tutorial #70,20972,1020,116,2020-06-23,Jun,76,1136
1178,CodeWithHarry,Hosting our PHP Website on a Server | PHP Tutorial #69,99173,2939,279,2020-06-22,Jun,54,3218
1179,CodeWithHarry,this Pointer in C++ | C++ Tutorials for Beginners #53,177005,6621,256,2020-06-22,Jun,53,6877
1180,CodeWithHarry,Further Modifications to iDiscuss Forum Project | PHP Tutorial #68,15912,803,136,2020-06-21,Jun,66,939
1181,CodeWithHarry,Array of Objects Using Pointers in C++ | C++ Tutorials for Beginners #52,133251,7028,410,2020-06-21,Jun,72,7438
1182,CodeWithHarry,What is Serverless Computing? (In Hindi),35212,2544,535,2020-06-20,Jun,40,3079
1183,CodeWithHarry,Creating Logic for Pulling Search Results From the Database | PHP Tutorial #67,21671,894,107,2020-06-20,Jun,78,1001
1184,CodeWithHarry,How Much Python Do You Need To Learn Before Django?,170837,9997,594,2020-06-19,Jun,51,10591
1185,CodeWithHarry,Pointers to Objects and Arrow Operator in CPP | C++ Tutorials for Beginners #51,157993,6980,180,2020-06-19,Jun,79,7160
1186,CodeWithHarry,Creating a Template for Displaying Search Results | PHP Tutorial #66,36084,1199,138,2020-06-19,Jun,68,1337
1187,CodeWithHarry,Which Programming Language to Learn First?,1146230,62841,3708,2020-06-18,Jun,42,66549
1188,CodeWithHarry,8 Programming Languages in ONLY 10 minutes!,69222,6074,688,2020-06-17,Jun,43,6762
1189,CodeWithHarry,Revisiting Pointers: new and delete Keywords in CPP | C++ Tutorials for Beginners #50,167467,6763,241,2020-06-17,Jun,85,7004
1190,CodeWithHarry,How to Learn To Code From Zero and Get a Coding Job,1042359,57246,2827,2020-06-16,Jun,51,60073
1191,CodeWithHarry,Displaying Header Categories Dynamically from the Database | PHP Tutorial #65,18325,775,106,2020-06-16,Jun,77,881
1192,CodeWithHarry,Website on WordPress Vs HTML CSS & JavaScript,525416,27791,1906,2020-06-15,Jun,45,29697
1193,CodeWithHarry,Saving PHP Website From a Potential XSS Attack | PHP Tutorial #64,26581,1298,163,2020-06-15,Jun,65,1461
1194,CodeWithHarry,How To Make a WordPress Website | Wordpress Tutorial for Beginners | Elementor Tutorial In Hindi,4788710,130429,14120,2020-06-14,Jun,96,144549
1195,CodeWithHarry,Adding User Email with Comments and Posts | PHP Tutorial #63,21797,889,168,2020-06-14,Jun,60,1057
1196,CodeWithHarry,Restricting Posting and Commenting Activities to Logged in Users Only | PHP Tutorial #62,18473,925,141,2020-06-13,Jun,88,1066
1197,CodeWithHarry,Creating Logout Functionality + Other Header Fixes | PHP Tutorial #61,18818,838,112,2020-06-12,Jun,69,950
1198,CodeWithHarry,Creating Login Handler & Header for Logged in User | PHP Tutorial #60,30289,915,184,2020-06-10,Jun,69,1099
1199,CodeWithHarry,How To Write a Resume That Gets You a Job,447639,26061,1361,2020-06-10,Jun,41,27422
1200,CodeWithHarry,Creating Users Table and Signup Form For User Login | PHP Tutorial #59,31808,1033,159,2020-06-09,Jun,70,1192
1201,CodeWithHarry,Fastest Way To Become a Software Developer,3687573,156437,11726,2020-06-07,Jun,42,168163
1202,CodeWithHarry,C# Tutorial In Hindi,1442717,39238,3505,2020-06-06,Jun,20,42743
1203,CodeWithHarry,Adding Comments to Threads Using HTML Form | PHP Tutorial #58,20939,867,106,2020-06-05,Jun,61,973
1204,CodeWithHarry,Initialization list in Constructors in Cpp | C++ Tutorials for Beginners #49,107525,6244,267,2020-06-05,Jun,76,6511
1205,CodeWithHarry,Creating a Database to Store Comments | PHP Tutorial #57,24389,1275,106,2020-06-04,Jun,56,1381
1206,CodeWithHarry,Code Example: Constructors in Derived Class in Cpp | C++ Tutorials for Beginners #48,114457,6050,1126,2020-06-04,Jun,84,7176
1207,CodeWithHarry,Adding Questions to Our iDiscuss Forum Database | PHP Tutorial #56,23465,1008,180,2020-06-03,Jun,66,1188
1208,CodeWithHarry,Solution to Exercise on Cpp Inheritance | C++ Tutorials for Beginners #47,85949,3542,160,2020-06-03,Jun,73,3702
1209,CodeWithHarry,Generate Data Science/Data Analysis Report of your DataSet in 5 Minutes,171040,7435,670,2020-06-02,Jun,71,8105
1210,CodeWithHarry,Constructors in Derived Class in C++ | C++ Tutorials for Beginners #46,144384,6407,172,2020-06-02,Jun,70,6579
1211,CodeWithHarry,Creating a Form for Forum Threads & Comments | PHP Tutorial #55,27404,956,108,2020-06-01,Jun,63,1064
1212,CodeWithHarry,Code Example Demonstrating Virtual Base Class in C++ | C++ Tutorials for Beginners #45,139309,6976,390,2020-06-01,Jun,86,7366
1213,CodeWithHarry,How to run Python on Android Phones,477558,23446,2949,2020-05-30,May,35,26395
1214,CodeWithHarry,Virtual Base Class in C++ | C++ Tutorials for Beginners #44,169301,9202,266,2020-05-30,May,59,9468
1215,CodeWithHarry,PHP Forum Project: Creating a Page for Forum Threads & Comments | PHP Tutorial #54,29064,1037,137,2020-05-29,May,82,1174
1216,CodeWithHarry,How To Make a Website in 5 Minutes,2653401,146205,6921,2020-05-28,May,34,153126
1217,CodeWithHarry,PHP Forum Project: Creating A Table To Store Forum Threads | PHP Tutorial #53,27253,1013,141,2020-05-28,May,77,1154
1218,CodeWithHarry,"Create a Responsive Website Using HTML, CSS & JavaScript in Hindi",1639208,45016,4581,2020-05-27,May,65,49597
1219,CodeWithHarry,PHP Forum Project: Listing Threads from Each Category | PHP Tutorial #52,29339,1199,92,2020-05-27,May,72,1291
1220,CodeWithHarry,Ambiguity Resolution in Inheritance in C++ | C++ Tutorials for Beginners #43,135964,6681,321,2020-05-26,May,76,7002
1221,CodeWithHarry,PHP Forum Project: Creating a Page For Listing Threads From A Category | PHP Tutorial #51,32968,1007,75,2020-05-26,May,89,1082
1222,CodeWithHarry,I Created a Realtime Chat Application Using NodeJs and SocketIO,810102,21453,3735,2020-05-25,May,63,25188
1223,CodeWithHarry,Exercise on C++ Inheritance | C++ Tutorials for Beginners #42,104121,5369,564,2020-05-25,May,61,5933
1224,CodeWithHarry,How I Secure My Passwords Using Python,32158,1266,252,2020-05-24,May,38,1518
1225,CodeWithHarry,PHP Forum Project: Pulling Categories From the Database | PHP Tutorial #50,37945,1183,97,2020-05-24,May,74,1280
1226,CodeWithHarry,Multiple Inheritance Deep Dive with Code Example in C++ | C++ Tutorials for Beginners #41,130411,7245,265,2020-05-24,May,89,7510
1227,CodeWithHarry,"PHP Forum Project: Adding Login Modals, About & Contact Pages | PHP Tutorial #49",42236,1261,119,2020-05-23,May,80,1380
1228,CodeWithHarry,PHP Forum Project: Creating Category Table & Designing Layout | PHP Tutorial #48,46662,1923,101,2020-05-22,May,80,2024
1229,CodeWithHarry,Multilevel Inheritance Deep Dive with Code Example in C++ | C++ Tutorials for Beginners #40,151731,7844,393,2020-05-21,May,91,8237
1230,CodeWithHarry,PHP Project:Creating An Online Forum In php From Scratch | PHP Tutorial #47,73727,2545,187,2020-05-21,May,75,2732
1231,CodeWithHarry,PHP Login System Tutorial: password_hash() and password_verify() in php | PHP Tutorial #46,53805,1831,194,2020-05-20,May,90,2025
1232,CodeWithHarry,Protected Access Modifier in C++ | C++ Tutorials for Beginners #39,136881,6292,148,2020-05-19,May,66,6440
1233,CodeWithHarry,PHP Login System Tutorial: Password Hashing | PHP Tutorial #45,40975,1829,146,2020-05-19,May,62,1975
1234,CodeWithHarry,I Created an Automatic Birthday Wisher To Auto-Wish Friends In Python,97828,4245,803,2020-05-17,May,69,5048
1235,CodeWithHarry,JavaScript Tutorial In Hindi,5982838,181842,23545,2020-05-16,May,28,205387
1236,CodeWithHarry,PHP Login System Tutorial: Adding Logout Functionality | PHP Tutorial #44,48846,1990,135,2020-05-15,May,73,2125
1237,CodeWithHarry,Single Inheritance Deep Dive: Examples + Code | C++ Tutorials for Beginners #38,181099,9200,490,2020-05-15,May,79,9690
1238,CodeWithHarry,PHP Login System Tutorial: Adding UNIQUE constraint to username | PHP Tutorial #43,55976,2437,129,2020-05-14,May,82,2566
1239,CodeWithHarry,Inheritance Syntax & Visibility Mode in C++ | C++ Tutorials for Beginners #37,239108,8971,305,2020-05-14,May,77,9276
1240,CodeWithHarry,PHP Login System Tutorial: Creating Login Page & Script in PHP | PHP Tutorial #42,94751,3027,188,2020-05-13,May,81,3215
1241,CodeWithHarry,Inheritance & Its Different Types with Examples in C++ | C++ Tutorials for Beginners #36,373170,16078,526,2020-05-13,May,88,16604
1242,CodeWithHarry,PHP Login System Tutorial: Creating Tables and SignUp Form | PHP Tutorial #41,142800,3415,268,2020-05-13,May,77,3683
1243,CodeWithHarry,PHP Login System Tutorial: Creating a Login + Registration System in PHP | PHP Tutorial #40,312252,7888,232,2020-05-12,May,91,8120
1244,CodeWithHarry,PHP Sessions: $_SESSION & Starting a Session in PHP | PHP Tutorial #39,135524,4042,173,2020-05-12,May,70,4215
1245,CodeWithHarry,I Created a Password Generator using Python,81995,3149,407,2020-05-11,May,43,3556
1246,CodeWithHarry,Setting Cookies & $_COOKIE super global in PHP in Hindi | PHP Tutorial #38,104449,3462,131,2020-05-11,May,74,3593
1247,CodeWithHarry,Writing and Appending to Files in PHP in Hindi | PHP Tutorial #37,33739,1390,98,2020-05-11,May,65,1488
1248,CodeWithHarry,I Created a Drink Water Notification Reminder App in Python,154269,5684,509,2020-05-10,May,59,6193
1249,CodeWithHarry,"fgetc(), & fgets() in PHP in Hindi | PHP Tutorial #36",33127,1546,268,2020-05-10,May,53,1814
1250,CodeWithHarry,Data Preprocessing in Python,30916,821,76,2020-05-10,May,28,897
1251,CodeWithHarry,"fopen(), fread() & fclose() in PHP in Hindi | PHP Tutorial #35",52221,1797,108,2020-05-09,May,62,1905
1252,CodeWithHarry,Working with Files: File I/O in PHP in Hindi | PHP Tutorial #34,65223,2661,212,2020-05-09,May,63,2873
1253,CodeWithHarry,Include and Require in PHP in Hindi | PHP Tutorial #33,50104,1911,121,2020-05-08,May,54,2032
1254,CodeWithHarry,Bootstrap Tutorial In Hindi,1624239,47303,5129,2020-05-07,May,27,52432
1255,CodeWithHarry,"Php CRUD Operations Tutorial Using MySQLi in Hindi - Select, Insert, Update, Delete|PHP Tutorial #32",257088,5418,989,2020-05-07,May,100,6407
1256,CodeWithHarry,Deleting Records in PHP & Limit Clause in Hindi | PHP Tutorial #31,48178,1999,176,2020-05-06,May,66,2175
1257,CodeWithHarry,"Adding ""Post Views"" (View Counter) to iCoder Django 3 Blog|  Python Django Tutorials In Hindi #101",40564,884,336,2020-05-05,May,98,1220
1258,CodeWithHarry,Updating Records in PHP & Where Clause in Hindi | PHP Tutorial #30,74979,2199,128,2020-05-05,May,66,2327
1259,CodeWithHarry,Integrating TinyMCE Editor in Django Admin | Python Django Tutorials In Hindi #100,19423,481,143,2020-05-04,May,82,624
1260,CodeWithHarry,Selecting and Displaying Data From MySQL Using MySQLi in Hindi | PHP Tutorial #29,132022,3452,183,2020-05-04,May,81,3635
1261,CodeWithHarry,Creating a Bootstrap Form and Saving Data Into MySQL DataBase Using MySQLi  | PHP Tutorial #28,128756,3222,259,2020-05-04,May,94,3481
1262,CodeWithHarry,I Automated The Chrome Dinosaur Game Using Python 🔥,304117,14391,3056,2020-05-03,May,51,17447
1263,CodeWithHarry,I Created an Automatic Folder Cleaner in Python,39160,1692,286,2020-05-02,May,47,1978
1264,CodeWithHarry,Insert Data Into MySQL Using MySQLi using php | PHP Tutorial #27,142999,4085,654,2020-05-02,May,64,4739
1265,CodeWithHarry,Using TinyMCE Editor For Editing Blog Post Content | Python Django Tutorials In Hindi #99,18102,438,79,2020-05-01,May,89,517
1266,CodeWithHarry,Creating a Table in MySQL using php | PHP Tutorial #26,141571,5020,485,2020-05-01,May,54,5505
1267,CodeWithHarry,Transparent Login Form using HTML and CSS | Web Development Tutorials #101,225245,5448,418,2020-04-30,Apr,74,5866
1268,CodeWithHarry,Creating a MySQL Database using php | PHP Tutorial #25,185694,7847,192,2020-04-30,Apr,54,8039
1269,CodeWithHarry,Connecting to MySQL Database from Php Script | PHP Tutorial #24,347958,7809,846,2020-04-30,Apr,63,8655
1270,CodeWithHarry,Django 3 Blog: Rendering HTML inside the Blog Post | Python Django Tutorials In Hindi #98,11529,325,58,2020-04-30,Apr,89,383
1271,CodeWithHarry,phpMyAdmin Tutorial: Creating Database & Tables | PHP Tutorial #23,238522,4905,147,2020-04-29,Apr,66,5052
1272,CodeWithHarry,Django 3 Blog: Designing Replies Below Comments & Other Fixes | Python Django Tutorials In Hindi #97,9031,323,73,2020-04-29,Apr,100,396
1273,CodeWithHarry,Using RDBMS & SQL With php | PHP Tutorial #22,122341,3778,218,2020-04-29,Apr,45,3996
1274,CodeWithHarry,PHP Forms Tutorial: GET & POST Requests in php | PHP Tutorial #21,218854,4314,200,2020-04-28,Apr,65,4514
1275,CodeWithHarry,Django 3 Blog: Displaying Replies Below Corresponding Comment | Python Django Tutorials In Hindi #96,10576,399,89,2020-04-27,Apr,100,488
1276,CodeWithHarry,"Scope, Local & Global Variables in Php | PHP Tutorial #20",76985,2702,153,2020-04-26,Apr,57,2855
1277,CodeWithHarry,Django 3 Blog: Adding Replies to Comments on Our Blog | Python Django Tutorials In Hindi #95,14986,390,69,2020-04-26,Apr,92,459
1278,CodeWithHarry,Django 3 Blog: Restricting Comment Posting to Logged in User | Python Django Tutorials In Hindi #94,10268,435,73,2020-04-25,Apr,99,508
1279,CodeWithHarry,Multi-Dimensional Arrays in Php | PHP Tutorial #19,81998,3030,219,2020-04-25,Apr,50,3249
1280,CodeWithHarry,Associative Arrays in Php | PHP Tutorial #18,90257,2782,169,2020-04-24,Apr,44,2951
1281,CodeWithHarry,Date Function: Handling Dates in Php | PHP Tutorial #17,81277,2712,215,2020-04-23,Apr,55,2927
1282,CodeWithHarry,Functions in Php | PHP Tutorial #16,113490,2974,201,2020-04-22,Apr,35,3175
1283,CodeWithHarry,Django 3 Blog: Rendering Blog Comments on Our Template | Python Django Tutorials In Hindi #93,11268,380,92,2020-04-21,Apr,93,472
1284,CodeWithHarry,foreach Loops in php | PHP Tutorial #15,78727,2653,83,2020-04-21,Apr,39,2736
1285,CodeWithHarry,Django 3 Blog: Creating APIs for Posting Comments on Blog | Python Django Tutorials In Hindi #92,24752,517,89,2020-04-20,Apr,96,606
1286,CodeWithHarry,do-While Loops in php | PHP Tutorial #14,61212,3087,517,2020-04-20,Apr,40,3604
1287,CodeWithHarry,"Django 3 Blog: Creating Comment Model, Template & Migrations | Python Django Tutorials In Hindi #91",15069,476,72,2020-04-19,Apr,99,548
1288,CodeWithHarry,For Loops in php | PHP Tutorial #13,74981,2379,96,2020-04-19,Apr,35,2475
1289,CodeWithHarry,Git Tutorial: How to Upload your Projects to Git & GitHub | Web Development Tutorials #100,598502,20295,3699,2020-04-18,Apr,90,23994
1290,CodeWithHarry,While Loops in php | PHP Tutorial #12,80568,2785,136,2020-04-18,Apr,37,2921
1291,CodeWithHarry,Get a Free https SSL Certificate For Your Domain on Ubuntu VPS | Web Development Tutorials #99,67935,2002,244,2020-04-18,Apr,94,2246
1292,CodeWithHarry,Switch Case Statements in php | PHP Tutorial #11,80807,3488,382,2020-04-16,Apr,48,3870
1293,CodeWithHarry,If Else Conditionals in Php | PHP Tutorial #10,102061,3463,244,2020-04-15,Apr,46,3707
1294,CodeWithHarry,Operators in Php | PHP Tutorial #9,120580,3195,117,2020-04-15,Apr,34,3312
1295,CodeWithHarry,String Functions in Php | PHP Tutorial #8,140292,3843,127,2020-04-14,Apr,41,3970
1296,CodeWithHarry,Installing MongoDb & Hosting our Dance Website on Ubuntu VPS | Web Development Tutorials #98,57724,1628,171,2020-04-13,Apr,92,1799
1297,CodeWithHarry,Django 3 Blog: Creating Blog Comments in Django | Python Django Tutorials In Hindi #90,17772,629,132,2020-04-13,Apr,86,761
1298,CodeWithHarry,Data Types in Php | PHP Tutorial #7,141646,4281,104,2020-04-13,Apr,35,4385
1299,CodeWithHarry,Rules for Creating Variables in Php | PHP Tutorial #6,130376,4275,167,2020-04-12,Apr,53,4442
1300,CodeWithHarry,Php Variables | PHP Tutorial #5,175514,4624,190,2020-04-12,Apr,31,4814
1301,CodeWithHarry,Php Comments & Using Php with Bootstrap | PHP Tutorial #4,215153,5323,185,2020-04-11,Apr,57,5508
1302,CodeWithHarry,"Web Development 101: How HTML, CSS, JavaScript & PHP Work Together | PHP Tutorial #3",303803,7291,158,2020-04-10,Apr,84,7449
1303,CodeWithHarry,Creating Our First PHP Website | PHP Tutorial #2,551834,11340,578,2020-04-10,Apr,48,11918
1304,CodeWithHarry,"Installing XAMPP, VS Code + Environment Setup | PHP Tutorial #1",1037116,19943,2965,2020-04-10,Apr,63,22908
1305,CodeWithHarry,Hosting Tutorial: Deploy NodeJs Apps in Production on Linux VPS | Web Development Tutorials#97,73288,1783,201,2020-04-09,Apr,94,1984
1306,CodeWithHarry,Hosting Tutorial: Host Multiple Websites On One Single Hosting Server | Web Development Tutorials#96,99826,4068,290,2020-04-08,Apr,100,4358
1307,CodeWithHarry,Hosting Tutorial: Linking Domain to the Web Hosting Server | Web Development Tutorials #95,58772,2242,245,2020-04-06,Apr,90,2487
1308,CodeWithHarry,Hosting Tutorial: Using Filezilla & WinSCP to upload Files | Web Development Tutorials #94,40765,1290,137,2020-04-06,Apr,90,1427
1309,CodeWithHarry,Hosting Tutorial: CoronaVirus Information Website With Hosting | Web Development Tutorials #93,71793,1936,360,2020-04-05,Apr,94,2296
1310,CodeWithHarry,Hosting Tutorial: Installing Apache2 Web Server on a VPS | Web Development Tutorials #92,57163,1892,161,2020-04-04,Apr,88,2053
1311,CodeWithHarry,Hosting Tutorial: Installing Putty + Basic Linux Commands | Web Development Tutorials #91,94953,2385,146,2020-04-04,Apr,89,2531
1312,CodeWithHarry,Hosting Tutorial: Creating Our First VPS | Web Development Tutorials #90,94886,2870,363,2020-04-04,Apr,72,3233
1313,CodeWithHarry,Destructor in C++ in Hindi | C++ Tutorials for Beginners #35,189829,7569,202,2020-04-04,Apr,60,7771
1314,CodeWithHarry,Hosting Tutorial: Where to Host your Website? | Web Development Tutorials #89,172550,6327,366,2020-04-03,Apr,77,6693
1315,CodeWithHarry,Backend Tutorial: Saving Data To The Database Using Pug + NodeJs | Web Development Tutorials #88,121779,3702,640,2020-04-03,Apr,96,4342
1316,CodeWithHarry,Django Tutorial In Hindi,1534053,35794,5853,2020-04-01,Apr,24,41647
1317,CodeWithHarry,Plotting CoronaVirus Cases On World Map - Interactive Dashboard Using JavaScript & MapBox,173234,4856,936,2020-03-27,Mar,89,5792
1318,CodeWithHarry,Copy Constructor in C++ | C++ Tutorials for Beginners #34,247931,12505,526,2020-03-27,Mar,57,13031
1319,CodeWithHarry,MongoDb Tutorial: Using Mongoose in NodeJs | Web Development Tutorials #86,111394,3471,321,2020-03-26,Mar,74,3792
1320,CodeWithHarry,Covid -19: Creating a Realtime CoronaVirus Outbreak Notification System Using Python Programming,111245,2700,620,2020-03-22,Mar,96,3320
1321,CodeWithHarry,CoronaVirus: Python Programming Solution to the Problem,138197,5536,753,2020-03-20,Mar,55,6289
1322,CodeWithHarry,Dynamic Initialization of Objects Using Constructors | C++ Tutorials for Beginners #33,205803,9898,267,2020-03-18,Mar,86,10165
1323,CodeWithHarry,Constructors With Default Arguments In C++ | C++ Tutorials for Beginners #32,146485,9539,227,2020-03-14,Mar,76,9766
1324,CodeWithHarry,Constructor Overloading In C++ | C++ Tutorials for Beginners #31,181827,6415,143,2020-03-12,Mar,64,6558
1325,CodeWithHarry,Parameterized and Default Constructors In C++ | C++ Tutorials for Beginners #30,232570,7448,876,2020-03-11,Mar,79,8324
1326,CodeWithHarry,Constructors In C++ | C++ Tutorials for Beginners #29,410808,11934,283,2020-03-11,Mar,53,12217
1327,CodeWithHarry,More on C++ Friend Functions (Examples & Explanation) | C++ Tutorials for Beginners #28,189183,7323,662,2020-03-09,Mar,87,7985
1328,CodeWithHarry,Friend Classes & Member Friend Functions in C++ | C++ Tutorials for Beginners #27,291438,9577,414,2020-03-08,Mar,81,9991
1329,CodeWithHarry,MongoDb Tutorial: MongoDb Compass & Installing Mongoose | Web Development Tutorials #85,100988,3694,290,2020-03-07,Mar,87,3984
1330,CodeWithHarry,Friend Functions in C++ | C++ Tutorials for Beginners #26,421381,15916,1414,2020-03-07,Mar,57,17330
1331,CodeWithHarry,MongoDb Tutorial: Updating data from the Mongo Database | Web Development Tutorials #84,65558,3562,121,2020-03-06,Mar,87,3683
1332,CodeWithHarry,MongoDb Tutorial: Deleting data from the Mongo Database | Web Development Tutorials #83,61580,3296,370,2020-03-05,Mar,87,3666
1333,CodeWithHarry,MongoDb Tutorial: Searching/Querying data from the Mongo Database | Web Development Tutorials #82,78056,3272,114,2020-03-04,Mar,97,3386
1334,CodeWithHarry,MongoDb Tutorial: Inserting data into the Mongo Database | Web Development Tutorials #81,118978,4251,348,2020-03-04,Mar,88,4599
1335,CodeWithHarry,Array of Objects & Passing Objects as Function Arguments in C++ | C++ Tutorials for Beginners #25,305459,10152,324,2020-03-03,Mar,97,10476
1336,CodeWithHarry,Static Data Members & Methods in C++ OOPS | C++ Tutorials for Beginners #24,392472,10541,274,2020-03-02,Mar,75,10815
1337,CodeWithHarry,C++ Objects Memory Allocation & using Arrays in Classes | C++ Tutorials for Beginners #23,388459,11343,436,2020-03-01,Mar,89,11779
1338,CodeWithHarry,OOPs Recap & Nesting of Member Functions in C++ | C++ Tutorials for Beginners #22,482601,13632,906,2020-03-01,Mar,81,14538
1339,CodeWithHarry,MongoDb Tutorial: Introduction to MongoDb + Installation | Web Development Tutorials #80,204093,6359,461,2020-03-01,Mar,88,6820
1340,CodeWithHarry,Backend Tutorial: Adding a Contact Form using Pug + NodeJs | Web Development Tutorials #79,131616,4154,413,2020-02-29,Feb,90,4567
1341,CodeWithHarry,Backend Tutorial: Adding Sponsor Section using Pug + NodeJs | Web Development Tutorials #78,78048,2966,95,2020-02-29,Feb,91,3061
1342,CodeWithHarry,Backend Tutorial: Continuing Dance Website using Pug + NodeJs | Web Development Tutorials #77,91199,3070,182,2020-02-28,Feb,93,3252
1343,CodeWithHarry,Backend Tutorial: Designing Cards Using Pure Pug + NodeJs | Web Development Tutorials #76,90069,2937,93,2020-02-27,Feb,89,3030
1344,CodeWithHarry,Backend Tutorial: Dance Website Using Pure Pug + NodeJs | Web Development Tutorials #75,176943,4395,562,2020-02-26,Feb,87,4957
1345,CodeWithHarry,Backend Tutorial: Finishing Off NodeJs Backend of our Gym Website | Web Development Tutorials #74,139447,4655,436,2020-02-25,Feb,97,5091
1346,CodeWithHarry,Backend Tutorial: Using raw HTML in Pug template engine | Web Development Tutorials #73,171999,4532,403,2020-02-24,Feb,87,4935
1347,CodeWithHarry,Backend Tutorial: Static Files & Installing Pug template engine | Web Development Tutorials #72,168613,6409,1086,2020-02-23,Feb,95,7495
1348,CodeWithHarry,Backend Tutorial: Writing our first Express App | Web Development Tutorials #71,188388,5849,482,2020-02-22,Feb,79,6331
1349,CodeWithHarry,Backend Tutorial: Installing Express and Postman | Web Development Tutorials #70,184200,6794,493,2020-02-20,Feb,80,7287
1350,CodeWithHarry,Backend Tutorial: npm: The Node Package Manager Tutorial | Web Development Tutorials #69,183191,7644,781,2020-02-17,Feb,88,8425
1351,CodeWithHarry,Backend Tutorial: Creating Custom Modules in Node Using NodeJs | Web Development Tutorials #68,173059,7197,285,2020-02-16,Feb,94,7482
1352,CodeWithHarry,Backend Tutorial: Creating a Custom Backend Using NodeJs | Web Development Tutorials #67,293808,9140,2111,2020-02-14,Feb,88,11251
1353,CodeWithHarry,Backend Tutorial: Serving HTML Files using NodeJs | Web Development Tutorials #66,207822,6955,370,2020-02-14,Feb,81,7325
1354,CodeWithHarry,Backend Tutorial: Blocking vs Non-Blocking execution | Web Development Tutorials #65,225274,8987,253,2020-02-13,Feb,84,9240
1355,CodeWithHarry,Backend Tutorial: Node.Js Modules with Examples | Web Development Tutorials #64,306509,8874,560,2020-02-12,Feb,79,9434
1356,CodeWithHarry,Backend Tutorial: Node.Js Introduction and Installation | Web Development Tutorials #63,612261,17689,4247,2020-02-11,Feb,87,21936
1357,CodeWithHarry,Php Tutorial for Beginners in Hindi with MySQL Project,2440502,61243,4378,2020-02-11,Feb,54,65621
1358,CodeWithHarry,JavaScript Tutorial: Working with JSON in JavaScript | Web Development Tutorials #62,271612,10611,745,2020-02-09,Feb,84,11356
1359,CodeWithHarry,JavaScript Tutorial: Math Object In JavaScript | Web Development Tutorials #61,192859,9745,348,2020-02-07,Feb,78,10093
1360,CodeWithHarry,"Classes, Public and Private access modifiers in C++ | C++ Tutorials for Beginners #21",655256,19320,743,2020-02-06,Feb,85,20063
1361,CodeWithHarry,JavaScript Tutorial: Arrow Functions In JavaScript | Web Development Tutorials #60,214522,9131,305,2020-02-06,Feb,82,9436
1362,CodeWithHarry,Object Oriented Programming in C++ | C++ Tutorials for Beginners #20,964137,27740,842,2020-02-05,Feb,68,28582
1363,CodeWithHarry,JavaScript Tutorial: Date & Time In JavaScript | Web Development Tutorials #59,247846,12554,1014,2020-02-05,Feb,78,13568
1364,CodeWithHarry,JavaScript Tutorial: setInterval & setTimeOut | Web Development Tutorials #58,277609,10429,428,2020-02-04,Feb,77,10857
1365,CodeWithHarry,Function Overloading with Examples in C++ | C++ Tutorials for Beginners #19,437873,13508,618,2020-02-03,Feb,75,14126
1366,CodeWithHarry,Recursions & Recursive Functions in C++ | C++ Tutorials for Beginners #18,382017,11809,548,2020-02-03,Feb,73,12357
1367,CodeWithHarry,JavaScript Tutorial: Events & Listening to Events | Web Development Tutorials #57,367916,11458,333,2020-02-02,Feb,81,11791
1368,CodeWithHarry,"Inline Functions, Default Arguments & Constant Arguments in C++ | C++ Tutorials for Beginners #17",501101,18251,423,2020-02-02,Feb,97,18674
1369,CodeWithHarry,JavaScript Tutorial: Navigating The DOM | Web Development Tutorials #56,294302,11539,232,2020-02-01,Feb,71,11771
1370,CodeWithHarry,Call by Value & Call by Reference in C++ | C++ Tutorials for Beginners #16,579113,16445,447,2020-02-01,Feb,74,16892
1371,CodeWithHarry,"JavaScript Tutorial: for, while, forEach, Do While Loops | Web Development Tutorials #55",283627,11060,389,2020-02-01,Feb,88,11449
1372,CodeWithHarry,Functions & Function Prototypes in C++ | C++ Tutorials for Beginners #15,686782,21169,702,2020-01-31,Jan,72,21871
1373,CodeWithHarry,"JavaScript Tutorial: Interaction - Alert, Prompt, Confirm | Web Development Tutorials #54",288384,12446,3003,2020-01-31,Jan,89,15449
1374,CodeWithHarry,Functions in JavaScript | Web Development Tutorials #53,304266,11786,648,2020-01-30,Jan,55,12434
1375,CodeWithHarry,"Structures, Unions & Enums in C++ | C++ Tutorials for Beginners #14",639586,19593,586,2020-01-30,Jan,67,20179
1376,CodeWithHarry,Arrays & Objects in JavaScript | Web Development Tutorials #52,301145,11705,304,2020-01-29,Jan,62,12009
1377,CodeWithHarry,"Scope, If-else Conditionals & Switch Case in JavaScript | Web Development Tutorials #51",321854,14334,456,2020-01-28,Jan,87,14790
1378,CodeWithHarry,String Functions in JavaScript | Web Development Tutorials #50,356382,12124,311,2020-01-27,Jan,62,12435
1379,CodeWithHarry,Strings in JavaScript | Web Development Tutorials #49,357783,14121,360,2020-01-26,Jan,53,14481
1380,CodeWithHarry,"Variables, Data Types and Operators in JavaScript | Web Development Tutorials #48",418132,13647,277,2020-01-25,Jan,81,13924
1381,CodeWithHarry,Arrays & Pointers Arithmetic in C++ | C++ Tutorials for Beginners #13,814813,21226,1943,2020-01-24,Jan,69,23169
1382,CodeWithHarry,Pointers in C++ | C++ Tutorials for Beginners #12,718922,22946,702,2020-01-24,Jan,49,23648
1383,CodeWithHarry,Writing in-browser JavaScript and Developer Console | Web Development Tutorials #47,407199,15189,232,2020-01-23,Jan,83,15421
1384,CodeWithHarry,Break and Continue Statements in C++ | C++ Tutorials for Beginners #11,473354,18197,383,2020-01-23,Jan,70,18580
1385,CodeWithHarry,Introduction to JavaScript for Frontend & Backend | Web Development Tutorials #46,632918,24094,811,2020-01-22,Jan,81,24905
1386,CodeWithHarry,Using Media Queries with CSS Grid | Web Development Tutorials #45,259581,12548,527,2020-01-22,Jan,65,13075
1387,CodeWithHarry,"For, While and do-while loops in C++ | C++ Tutorials for Beginners #10",795207,20699,5145,2020-01-21,Jan,70,25844
1388,CodeWithHarry,CSS Grid: Creating Layouts Using Grid Template Area | Web Development Tutorials #44,231777,13286,353,2020-01-21,Jan,83,13639
1389,CodeWithHarry,"C++ Control Structures, If Else and Switch-Case Statement | C++ Tutorials for Beginners #9",700735,20001,469,2020-01-21,Jan,90,20470
1390,CodeWithHarry,CSS Grid: Autofit & MinMax | Web Development Tutorials #43,217811,11794,287,2020-01-21,Jan,58,12081
1391,CodeWithHarry,"Constants, Manipulators & Operator Precedence | C++ Tutorials for Beginners #8",627624,19285,497,2020-01-20,Jan,78,19782
1392,CodeWithHarry,CSS Grid: Spanning Multiple Rows and Columns in Grid | Web Development Tutorials #42,238723,16305,651,2020-01-20,Jan,84,16956
1393,CodeWithHarry,CSS Grid: Creating Rows & Gaps in Grid | Web Development Tutorials #41,238723,12197,184,2020-01-19,Jan,70,12381
1394,CodeWithHarry,C++ Reference Variables & Typecasting | C++ Tutorials for Beginners #7,842662,23342,746,2020-01-19,Jan,70,24088
1395,CodeWithHarry,CSS Grid: Introduction & Creating A Basic Grid | Web Development Tutorials #40,380436,14049,350,2020-01-18,Jan,78,14399
1396,CodeWithHarry,C++ Header files & Operators | C++ Tutorials for Beginners #6,910969,25784,763,2020-01-18,Jan,61,26547
1397,CodeWithHarry,Creating Fully Responsive Website Project Using HTML & CSS  in Hindi | Web Development Tutorials #39,2646865,43386,2851,2020-01-17,Jan,100,46237
1398,CodeWithHarry,CSS Tutorial: Transform property in CSS | Web Development Tutorials #38,342804,15255,491,2020-01-16,Jan,71,15746
1399,CodeWithHarry,C++ Basic Input/Output & More | C++ Tutorials for Beginners #5,946493,25979,666,2020-01-15,Jan,62,26645
1400,CodeWithHarry,CSS Tutorial: Creating Transitions in CSS | Web Development Tutorials #37,371255,17688,453,2020-01-15,Jan,73,18141
1401,CodeWithHarry,Variable Scope & Data Types in C++ in Hindi | C++ Tutorials for Beginners #4,1304126,37402,1222,2020-01-14,Jan,76,38624
1402,CodeWithHarry,CSS Tutorial: Creating Animations & Keyframes | Web Development Tutorials #36,512368,17591,428,2020-01-14,Jan,77,18019
1403,CodeWithHarry,Variables & Comments in C++ in Hindi | C++ Tutorials for Beginners #3,1241966,39233,1098,2020-01-13,Jan,69,40331
1404,CodeWithHarry,CSS Tutorial: Variables & Custom Properties | Web Development Tutorials #35,305731,13952,340,2020-01-13,Jan,75,14292
1405,CodeWithHarry,Basic Structure of a C++ Program | C++ Tutorials for Beginners #2,1726154,56365,1944,2020-01-12,Jan,65,58309
1406,CodeWithHarry,CSS Tutorial: Box Shadow and Text Shadow | Web Development Tutorials #34,355587,14306,308,2020-01-12,Jan,72,14614
1407,CodeWithHarry,"Introduction to C++, Installing VS Code, g++ & more | C++ Tutorials for Beginners #1",4776237,110112,13176,2020-01-11,Jan,84,123288
1408,CodeWithHarry,CSS Tutorial: Before and After Pseudo Selectors | Web Development Tutorials #33,544162,17198,923,2020-01-11,Jan,79,18121
1409,CodeWithHarry,CSS Tutorial: Attribute & nth child pseudo Selectors | Web Development Tutorials #32,401816,15059,423,2020-01-10,Jan,84,15482
1410,CodeWithHarry,CSS Tutorial: More on CSS Selectors | Web Development Tutorials #31,403233,17416,466,2020-01-10,Jan,67,17882
1411,CodeWithHarry,CSS Tutorial: Media Queries Explained | Web Development Tutorials #30,667351,29409,793,2020-01-09,Jan,69,30202
1412,CodeWithHarry,"CSS Tutorial: em, rem, vh and vw units + Responsive design Explained | Web Development Tutorials #29",663690,19958,451,2020-01-09,Jan,100,20409
1413,CodeWithHarry,CSS Flexbox Tutorial in Hindi | Web Development Tutorials #28,1014378,27016,845,2020-01-08,Jan,61,27861
1414,CodeWithHarry,CSS Tutorial: Visibility & z-index Explained | Web Development Tutorials #27,580615,17547,390,2020-01-08,Jan,76,17937
1415,CodeWithHarry,Project 1: Creating a Gym Website Using HTML5 & CSS3 | Web Development Tutorials #26,1785006,43466,3187,2020-01-07,Jan,84,46653
1416,CodeWithHarry,"CSS Tutorial: Position absolute, relative, fixed and sticky in CSS | Web Development Tutorials #25",852648,27695,719,2020-01-07,Jan,98,28414
1417,CodeWithHarry,CSS Tutorial: CSS Display Property | Web Development Tutorials #24,801665,21117,665,2020-01-06,Jan,66,21782
1418,CodeWithHarry,CSS Tutorial: Creating a Navigation Menu | Web Development Tutorials #23,1029380,25424,695,2020-01-06,Jan,72,26119
1419,CodeWithHarry,CSS Tutorial: Styling Links & Buttons | Web Development Tutorials #22,727566,22602,468,2020-01-05,Jan,69,23070
1420,CodeWithHarry,CSS Tutorial: Float & Clear Explained | Web Development Tutorials #21,973197,32568,941,2020-01-05,Jan,69,33509
1421,CodeWithHarry,"CSS Tutorial: CSS Box Model, Margin and Padding | Web Development Tutorials #20",1046480,32869,837,2020-01-04,Jan,79,33706
1422,CodeWithHarry,Best & Fastest Way to Design Beautiful Websites (Amazing Technique!),187055,11137,521,2020-01-04,Jan,68,11658
1423,CodeWithHarry,CSS Tutorial: Borders and Backgrounds | Web Development Tutorials #19,834051,25476,695,2020-01-04,Jan,69,26171
1424,CodeWithHarry,CSS Tutorial: Colors In CSS | Web Development Tutorials #18,628305,23270,312,2020-01-03,Jan,59,23582
1425,CodeWithHarry,CSS Tutorial: Fonts In CSS | Web Development Tutorials #17,784374,27430,484,2020-01-03,Jan,58,27914
1426,CodeWithHarry,CSS Tutorial: Using Chrome Developer Tools | Web Development Tutorials #16,822789,25996,711,2020-01-02,Jan,74,26707
1427,CodeWithHarry,CSS Tutorial: Selectors in CSS | Web Development Tutorials #15,1016897,30455,698,2020-01-02,Jan,62,31153
1428,CodeWithHarry,Best Programming Language to learn for jobs,94889,5178,646,2020-01-01,Jan,43,5824
1429,CodeWithHarry,"CSS Tutorial: Inline, Internal & External CSS | Web Development Tutorials #14",1018011,28464,605,2020-01-01,Jan,77,29069
1430,CodeWithHarry,CSS Tutorial: Introduction to CSS | Web Development Tutorials #13,958336,29908,534,2020-01-01,Jan,65,30442
1431,CodeWithHarry,HTML Tutorial: Semantic Tags in HTML| Web Development Tutorials #12,847399,31615,818,2019-12-31,Dec,67,32433
1432,CodeWithHarry,HTML Tutorial: HTML Entities | Web Development Tutorials #11,803658,31374,671,2019-12-31,Dec,60,32045
1433,CodeWithHarry,HTML Tutorial: Ids & Classes in HTML | Web Development Tutorials #10,1018678,35297,1210,2019-12-30,Dec,68,36507
1434,CodeWithHarry,HTML Tutorial: Inline & Block Elements | Web Development Tutorials #9,1021719,31264,2776,2019-12-30,Dec,69,34040
1435,CodeWithHarry,HTML Tutorial: Forms & Input Tags | Web Development Tutorials #8,1712161,47398,1611,2019-12-29,Dec,64,49009
1436,CodeWithHarry,HTML Tutorial: Lists and Tables | Web Development Tutorials #7,1315507,35439,819,2019-12-29,Dec,62,36258
1437,CodeWithHarry,HTML Tutorial: Img and Anchor tags | Web Development Tutorials #6,1718187,48239,1412,2019-12-28,Dec,65,49651
1438,CodeWithHarry,Django 3 Blog: Creating Django template for Login & Logout | Python Django Tutorials In Hindi #89,24035,584,89,2019-12-28,Dec,97,673
1439,CodeWithHarry,HTML Tutorial: Headings & Paragraphs | Web Development Tutorials #5,1439473,43699,1095,2019-12-27,Dec,67,44794
1440,CodeWithHarry,"HTML Tutorial: Title, Script, Link & Meta Tags | Web Development Tutorials #4",1737725,44776,752,2019-12-27,Dec,77,45528
1441,CodeWithHarry,HTML Tutorial: Basic Structure of a Website | Web Development Tutorials #3,2024642,52116,1170,2019-12-26,Dec,74,53286
1442,CodeWithHarry,HTML Tutorial: Installing VS Code & Live Server | Web Development Tutorials #2,3236261,99167,3714,2019-12-25,Dec,78,102881
1443,CodeWithHarry,Django 3 Blog: Login & Logout Endpoints | Python Django Tutorials In Hindi #88,48129,809,65,2019-12-25,Dec,78,874
1444,CodeWithHarry,"Introduction to HTML, CSS, JavaScript & How websites work? | Web Development Tutorials #1",6043185,171732,14422,2019-12-25,Dec,89,186154
1445,CodeWithHarry,Django 3 Blog: Validating SignUp Form | Python Django Tutorials In Hindi #87,28900,648,128,2019-12-24,Dec,76,776
1446,CodeWithHarry,Django 3 Blog: Creating Users in Django | Python Django Tutorials In Hindi #86,35485,703,85,2019-12-23,Dec,78,788
1447,CodeWithHarry,Django 3 Blog: Authentication & Authorization Tutorial | Python Django Tutorials In Hindi #85,45247,959,74,2019-12-22,Dec,93,1033
1448,CodeWithHarry,Django 3 Blog: Improving Search Functionality | Python Django Tutorials In Hindi #84,17623,629,98,2019-12-21,Dec,84,727
1449,CodeWithHarry,Top 3 Worst Programming Languages to Learn,43834,2369,208,2019-12-16,Dec,42,2577
1450,CodeWithHarry,Top 3 Web Frameworks to learn,99940,5132,406,2019-12-15,Dec,29,5538
1451,CodeWithHarry,Three Must Learn Programming Languages,47617,3445,387,2019-12-14,Dec,38,3832
1452,CodeWithHarry,Django 3 Blog: Creating Search Functionality | Python Django Tutorials In Hindi #83,34032,784,72,2019-12-13,Dec,83,856
1453,CodeWithHarry,Web Scraping Tutorial using Python and BeautifulSoup in Hindi,492966,14024,921,2019-12-10,Dec,61,14945
1454,CodeWithHarry,Django 3 Blog: Designing the BlogPost Page | Python Django Tutorials In Hindi #82,14173,414,47,2019-12-09,Dec,81,461
1455,CodeWithHarry,Django 3 Blog: Creating Blog Model to Store Blog Posts | Python Django Tutorials In Hindi #81,19340,463,43,2019-12-08,Dec,93,506
1456,CodeWithHarry,Django 3 Blog: Designing Blog Page & Displaying Blog Posts | Python Django Tutorials In Hindi #80,16984,483,39,2019-12-07,Dec,97,522
1457,CodeWithHarry,Django Mesasges Framework: Showing Messages in Django blog | Python Django Tutorials In Hindi #79,24956,617,56,2019-12-06,Dec,97,673
1458,CodeWithHarry,Django 3 Blog: Handling Post Request in a Django View | Python Django Tutorials In Hindi #78,22358,483,73,2019-12-05,Dec,92,556
1459,CodeWithHarry,"Project 7: Creating a Calculator using HTML, CSS & JS | JavaScript Tutorial In Hindi #65",332479,6993,398,2019-12-05,Dec,88,7391
1460,CodeWithHarry,"Django 3 Blog: Creating ""Contact Us"" Model | Python Django Tutorials In Hindi #77",23765,525,37,2019-12-04,Dec,81,562
1461,CodeWithHarry,Django 3 Blog: Creating Migrations & Superusers | Python Django Tutorials In Hindi #76,15133,499,34,2019-12-04,Dec,86,533
1462,CodeWithHarry,Installing Django 3 for our Django Blog | Python Django Tutorials In Hindi #75,12281,432,37,2019-12-03,Dec,78,469
1463,CodeWithHarry,Django Blog: Adding HTML Templates | Python Django Tutorials In Hindi #74,22741,545,50,2019-12-03,Dec,73,595
1464,CodeWithHarry,Django Blog: Creating Django Apps & Properly Managing Them | Python Django Tutorials In Hindi #73,16373,507,43,2019-12-02,Dec,97,550
1465,CodeWithHarry,Django Blog: Project Setup & URLConfs | Python Django Tutorials In Hindi #72,20159,565,56,2019-12-02,Dec,76,621
1466,CodeWithHarry,Creating A New Django Blog (Setup + Introduction) | Python Django Tutorials In Hindi #71,25318,952,151,2019-12-01,Dec,88,1103
1467,CodeWithHarry,Adding OnClick Listener to RecyclerView | Android Tutorials in Hindi #34,74614,1415,383,2019-12-01,Dec,72,1798
1468,CodeWithHarry,Creating a RecyclerViewAdaper Class | Android Tutorials in Hindi #33,44917,749,98,2019-12-01,Dec,68,847
1469,CodeWithHarry,Pushing Git Branches To Remote Repositories | Git Tutorials #19,57170,3025,485,2019-11-27,Nov,63,3510
1470,CodeWithHarry,Windows vs Linux vs Mac for Programming?,153190,7457,1142,2019-11-24,Nov,40,8599
1471,CodeWithHarry,How to Become a Web Developer? (Hindi),187772,11551,569,2019-11-21,Nov,38,12120
1472,CodeWithHarry,Git Branching Workflow in Production | Git Tutorials #18,59768,2730,165,2019-11-10,Nov,56,2895
1473,CodeWithHarry,Resolving Merge Conflicts (With Example) | Git Tutorials #17,87563,3578,144,2019-11-09,Nov,60,3722
1474,CodeWithHarry,Branching & Merging a Production Grade Project | Git Tutorials #16,54712,2206,88,2019-11-08,Nov,66,2294
1475,CodeWithHarry,Git: Creating & Switching Branches In Git | Git Tutorials #15,60881,3039,132,2019-11-03,Nov,61,3171
1476,CodeWithHarry,Drag & Drop Elements with JavaScript and HTML | JavaScript Tutorial In Hindi #64,76948,2082,112,2019-11-01,Nov,80,2194
1477,CodeWithHarry,Setting Alias In Git | Git Tutorials #14,40254,1895,74,2019-10-31,Oct,40,1969
1478,CodeWithHarry,GitHub: Working with Remote Repositories | Git Tutorials #13,88219,2860,170,2019-10-30,Oct,60,3030
1479,CodeWithHarry,Project 6: PostMan Clone - Creating a Get/Post Request Website | JavaScript Tutorial In Hindi #63,68292,1634,99,2019-10-29,Oct,97,1733
1480,CodeWithHarry,Unstaging & Unmodifying Files In Git | Git Tutorials #12,50505,2211,106,2019-10-29,Oct,56,2317
1481,CodeWithHarry,Git Log: Viewing & Changing Commits In Git | Git Tutorials #11,64717,2422,94,2019-10-28,Oct,62,2516
1482,CodeWithHarry,Moving and Renaming Files In Git | Git Tutorials #10,62494,2925,87,2019-10-27,Oct,52,3012
1483,CodeWithHarry,Git: Skipping The Staging Area | Git Tutorials #9,56088,2591,79,2019-10-26,Oct,49,2670
1484,CodeWithHarry,Git Diff: Showing Changes Between Commits/Staging Area & Working Directory | Git Tutorials #8,71513,2951,69,2019-10-26,Oct,93,3020
1485,CodeWithHarry,.gitignore: Ignoring Files in Git | Git Tutorials #7,123862,3876,113,2019-10-25,Oct,52,3989
1486,CodeWithHarry,Git: File Status Lifecycle | Git Tutorials #6,93344,3900,106,2019-10-24,Oct,45,4006
1487,CodeWithHarry,Cloning a Remote Git Repository from GitHub | Git Tutorials #5,134748,4380,112,2019-10-24,Oct,62,4492
1488,CodeWithHarry,Tracking Our first Git Project | Git Tutorials #4,148583,5562,147,2019-10-23,Oct,49,5709
1489,CodeWithHarry,Git: Three Stage Architecture | Git Tutorials #3,149533,5756,123,2019-10-23,Oct,48,5879
1490,CodeWithHarry,Installing Git + Initial Setup? | Git Tutorials #2,287896,9387,326,2019-10-22,Oct,50,9713
1491,CodeWithHarry,What is Git/GitHub & Why do we need it? | Git Tutorials #1,456278,14064,381,2019-10-22,Oct,58,14445
1492,CodeWithHarry,Creating a Clock: Exercise 6 Solution | JavaScript Tutorial In Hindi #62,28918,955,55,2019-10-21,Oct,72,1010
1493,CodeWithHarry,RecyclerView in Android | Android Tutorials in Hindi #32,80329,1531,124,2019-10-20,Oct,56,1655
1494,CodeWithHarry,SQLite Android CRUD: Adding ListView | Android Tutorials in Hindi #31,25225,582,164,2019-10-20,Oct,69,746
1495,CodeWithHarry,JavaScript Wall Clock: Exercise 6 | JavaScript Tutorial In Hindi #61,20068,736,66,2019-10-19,Oct,68,802
1496,CodeWithHarry,SQLite Android CRUD: Getting Count | Android Tutorials in Hindi #30,16744,491,103,2019-10-18,Oct,67,594
1497,CodeWithHarry,SQLite Android CRUD: Deleting Records | Android Tutorials in Hindi #29,16822,450,45,2019-10-18,Oct,70,495
1498,CodeWithHarry,SQLite Android CRUD: Updating Records | Android Tutorials in Hindi #28,22042,583,40,2019-10-17,Oct,70,623
1499,CodeWithHarry,JavaScript Destructuring | JavaScript Tutorial In Hindi #60,40162,1584,81,2019-10-17,Oct,59,1665
1500,CodeWithHarry,SQLite Android CRUD: Fetching all Contacts | Android Tutorials in Hindi #27,29187,639,91,2019-10-16,Oct,75,730
1501,CodeWithHarry,JavaScript Symbols | JavaScript Tutorial In Hindi #59,37145,1467,46,2019-10-16,Oct,53,1513
1502,CodeWithHarry,SQLite Android CRUD: Adding Contacts to the Database | Android Tutorials in Hindi #26,41459,1324,99,2019-10-15,Oct,85,1423
1503,CodeWithHarry,JavaScript Sets | JavaScript Tutorial In Hindi #58,34868,1562,156,2019-10-15,Oct,50,1718
1504,CodeWithHarry,SQLite Android CRUD: Implementing Database class | Android Tutorials in Hindi #25,93408,2025,95,2019-10-14,Oct,81,2120
1505,CodeWithHarry,JavaScript Maps | JavaScript Tutorial In Hindi #57,75612,2546,130,2019-10-14,Oct,50,2676
1506,CodeWithHarry,Using a Database in Android | Android Tutorials in Hindi #24,40620,1091,68,2019-10-13,Oct,60,1159
1507,CodeWithHarry,For.. of Loop vs For.. in Loop (When to use which?) | JavaScript Tutorial In Hindi #56,57196,2347,309,2019-10-13,Oct,86,2656
1508,CodeWithHarry,Shared Preferences: Saving data to Android device | Android Tutorials in Hindi #23,59406,1284,94,2019-10-12,Oct,82,1378
1509,CodeWithHarry,Parsing Nested JSON Arrays & Objects | Android Tutorials in Hindi #22,33938,664,77,2019-10-12,Oct,69,741
1510,CodeWithHarry,Android Exercise 3: Creating a User Display App | Android Tutorials in Hindi #21,23691,473,60,2019-10-11,Oct,80,533
1511,CodeWithHarry,Multiplication Tables App on Seekbar Change: Exercise 2: Solution | Android Tutorials in Hindi #20,29386,636,79,2019-10-11,Oct,98,715
1512,CodeWithHarry,Retrieve & Parse JSON Data from Web URL in Android | Android Tutorials in Hindi #19,71559,1414,128,2019-10-10,Oct,83,1542
1513,CodeWithHarry,Adding Volley Library dependency & Fake JSON API | Android Tutorials in Hindi #18,56152,1188,64,2019-10-10,Oct,81,1252
1514,CodeWithHarry,What is an API & how to use API in Android | Android Tutorials in Hindi #17,119984,2504,138,2019-10-09,Oct,75,2642
1515,CodeWithHarry,Performing Tasks in Background in Android | Android Tutorials in Hindi #16,40808,1024,100,2019-10-09,Oct,74,1124
1516,CodeWithHarry,"CountDownTimer, Runnable & Handler in Android | Android Tutorials in Hindi #15",36977,927,82,2019-10-08,Oct,78,1009
1517,CodeWithHarry,Multiplication Tables Application Project In Android | Android Tutorials in Hindi #14,27500,588,47,2019-10-08,Oct,85,635
1518,CodeWithHarry,Laptop Buying Guide: Which Laptop Should You Buy?,160947,11618,702,2019-10-07,Oct,49,12320
1519,CodeWithHarry,Android ListViews & Array Adapters | Android Tutorials in Hindi #13,71930,1590,116,2019-10-06,Oct,67,1706
1520,CodeWithHarry,Dynamic Photo Frame Application In Android Exercise 1: Solution | Android Tutorials in Hindi #12,54278,1149,140,2019-10-05,Oct,96,1289
1521,CodeWithHarry,Android SeekBar & its Methods | Android Tutorials in Hindi #11,46858,1099,228,2019-10-05,Oct,62,1327
1522,CodeWithHarry,MediaPlayer & Handling Audio in Android | Android Tutorials in Hindi #10,55112,1408,129,2019-10-04,Oct,72,1537
1523,CodeWithHarry,Embedding Video with media controls in Android | Android Tutorials in Hindi #9,50831,1288,115,2019-10-03,Oct,78,1403
1524,CodeWithHarry,Creating a Navigation Drawer App with Hamburger Icon In Android | Android Tutorials in Hindi #8,106216,2094,218,2019-10-02,Oct,95,2312
1525,CodeWithHarry,Creating a Multi Screen Android  Application | Android Tutorials in Hindi #7,161499,3206,343,2019-09-30,Sep,76,3549
1526,CodeWithHarry,Creating Photo Frame Application In Android: Exercise 1 | Android Tutorials in Hindi #6,79285,1558,292,2019-09-27,Sep,87,1850
1527,CodeWithHarry,Project 1: Tic Tac Toe Game Android Game Development | Android Tutorials in Hindi #5,357797,8143,1039,2019-09-26,Sep,84,9182
1528,CodeWithHarry,Android activity & Activity Lifecycle | Android Tutorials in Hindi #4,164863,4395,158,2019-09-25,Sep,69,4553
1529,CodeWithHarry,Linear Layout & Relative Layout In Android | Android Tutorials in Hindi #3,227392,4693,274,2019-09-24,Sep,74,4967
1530,CodeWithHarry,Project 5: Creating a CV Screener In JavaScript | JavaScript Tutorial In Hindi #55,44637,1439,73,2019-09-23,Sep,82,1512
1531,CodeWithHarry,Creating Our First Android App (with APK) | Android Tutorials in Hindi #2,1812960,24841,1134,2019-09-22,Sep,73,25975
1532,CodeWithHarry,Installing Android Studio & Setup | Android Tutorials in Hindi #1,1030937,26004,4614,2019-09-21,Sep,65,30618
1533,CodeWithHarry,5 Tips to Build & Improve Programming Logic,446808,30515,806,2019-09-17,Sep,43,31321
1534,CodeWithHarry,Should You Learn Django or Flask?,142938,6808,482,2019-09-15,Sep,33,7290
1535,CodeWithHarry,Project 4: Indian Railways Announcement Software | Python Tutorials For Absolute Beginners #124,142486,5144,483,2019-09-14,Sep,95,5627
1536,CodeWithHarry,[Solved] Unable to install Pyaudio - How to install using .whl wheel file,219376,5121,970,2019-09-13,Sep,73,6091
1537,CodeWithHarry,Alarm Clock In JavaScript | JavaScript Tutorial In Hindi #54,42437,1324,114,2019-09-11,Sep,60,1438
1538,CodeWithHarry,Should I learn PHP for Job?,139287,6865,523,2019-09-06,Sep,27,7388
1539,CodeWithHarry,Project 3: Third Umpire Decision Review System (DRS Gully Cricket) |Python Tutorials in Hindi #123,214817,7333,756,2019-09-04,Sep,98,8089
1540,CodeWithHarry,Top 5 programming languages,211626,4204,551,2019-09-01,Sep,27,4755
1541,CodeWithHarry,Generators in Javascript | JavaScript Tutorial In Hindi #53,44633,1771,76,2019-08-31,Aug,59,1847
1542,CodeWithHarry,Android Development Tutorial in Hindi,2492694,84832,13281,2019-08-30,Aug,37,98113
1543,CodeWithHarry,Creating an Alarm App: Exercise 6 | JavaScript Tutorial In Hindi #52,29042,1001,58,2019-08-28,Aug,68,1059
1544,CodeWithHarry,Iterators in JavaScript | JavaScript Tutorial In Hindi #51,48293,1717,69,2019-08-27,Aug,58,1786
1545,CodeWithHarry,Project 4: Form Validation using Regular Expressions | JavaScript Tutorial In Hindi #50,74629,2132,145,2019-08-26,Aug,87,2277
1546,CodeWithHarry,"Evaluating Classifiers in Python: Precision, Recall & F1 Score | Machine Learning Tutorials In Hindi",35078,948,155,2019-08-25,Aug,100,1103
1547,CodeWithHarry,Shorthand character classes (Regular Expressions) | JavaScript Tutorial In Hindi #49,36176,1670,50,2019-08-24,Aug,84,1720
1548,CodeWithHarry,Regular Expressions - Character sets | JavaScript Tutorial In Hindi #48,41461,1863,80,2019-08-23,Aug,71,1943
1549,CodeWithHarry,Regular Expressions - Metacharacters in JavaScript | JavaScript Tutorial In Hindi #47,49087,2025,86,2019-08-22,Aug,85,2111
1550,CodeWithHarry,JavaScript Regular Expressions & related functions | JavaScript Tutorial In Hindi #46,113178,3719,144,2019-08-21,Aug,85,3863
1551,CodeWithHarry,Using JavaScript Objects Exercise 5: Solution | JavaScript Tutorial In Hindi #45,29782,1058,57,2019-08-20,Aug,80,1115
1552,CodeWithHarry,"Precision, Recall, Confusion matrix & F1-Score | Machine Learning Tutorials Using Python In Hindi",62177,1883,317,2019-08-19,Aug,97,2200
1553,CodeWithHarry,Error Handling & Try Catch in Javascript | JavaScript Tutorial In Hindi #44,63757,2114,128,2019-08-18,Aug,75,2242
1554,CodeWithHarry,Handwritten Digit Recognition on MNIST dataset | Machine Learning Tutorials Using Python In Hindi,169162,3452,260,2019-08-17,Aug,97,3712
1555,CodeWithHarry,Async/Await in Javascript | JavaScript Tutorial In Hindi #43,225302,6298,235,2019-08-16,Aug,60,6533
1556,CodeWithHarry,Fetch api in Javascript | JavaScript Tutorial In Hindi #42,239757,5703,257,2019-08-15,Aug,58,5960
1557,CodeWithHarry,Arrow functions in Javascript | JavaScript Tutorial In Hindi #41,83965,2630,73,2019-08-14,Aug,64,2703
1558,CodeWithHarry,Project 1: End To End Python ML Project (Complete)| Machine Learning Tutorials Using Python In Hindi,845113,22901,2438,2019-08-13,Aug,100,25339
1559,CodeWithHarry,Project 3: Creating a News Website | JavaScript Tutorial In Hindi #40,139447,3226,443,2019-08-12,Aug,69,3669
1560,CodeWithHarry,"Promises Basics, Promise.then() & Promise.catch() | JavaScript Tutorial In Hindi #39",219149,5464,385,2019-08-11,Aug,84,5849
1561,CodeWithHarry,Coding Logistic Regression In Python | Machine Learning Tutorials Using Python In Hindi,90981,2705,196,2019-08-10,Aug,87,2901
1562,CodeWithHarry,Java tutorial in hindi 🔥,2408778,67300,6591,2019-08-09,Aug,24,73891
1563,CodeWithHarry,Using a Dictionary API Exercise 5 | JavaScript Tutorial In Hindi #38,45283,1207,72,2019-08-08,Aug,68,1279
1564,CodeWithHarry,Callback functions in javascript | JavaScript Tutorial In Hindi #37,191052,5739,653,2019-08-07,Aug,67,6392
1565,CodeWithHarry,Library Class Implementation Exercise 4: Solution | JavaScript Tutorial In Hindi #36,44365,1232,58,2019-08-06,Aug,84,1290
1566,CodeWithHarry,Ajax tutorial in hindi | JavaScript Tutorial In Hindi #35,435404,9443,463,2019-08-05,Aug,57,9906
1567,CodeWithHarry,What is Asynchronous Programming? | JavaScript Tutorial In Hindi #34,113317,4109,99,2019-08-04,Aug,68,4208
1568,CodeWithHarry,Project 2: Building a College Library Website | JavaScript Tutorial In Hindi #33,217127,5935,710,2019-08-03,Aug,80,6645
1569,CodeWithHarry,Implementing a library class - Exercise 4 | JavaScript Tutorial In Hindi #32,41677,1419,116,2019-08-02,Aug,76,1535
1570,CodeWithHarry,ES6 Classes and Inheritance | JavaScript Tutorial In Hindi #31,112952,3487,158,2019-07-31,Jul,62,3645
1571,CodeWithHarry,Prototype Inheritance In JavaScript | JavaScript Tutorial In Hindi #30,84339,2344,213,2019-07-30,Jul,70,2557
1572,CodeWithHarry,Notes App with Title - Exercise 3: Solution | JavaScript Tutorial In Hindi #29,56177,1622,110,2019-07-29,Jul,78,1732
1573,CodeWithHarry,Python Tutorial In Hindi 🔥,1982738,68742,9094,2019-07-27,Jul,26,77836
1574,CodeWithHarry,Object Prototype In javascript | JavaScript Tutorial In Hindi #28,106673,3050,115,2019-07-26,Jul,65,3165
1575,CodeWithHarry,Docker Tutorial in Hindi,458317,12887,1416,2019-07-25,Jul,24,14303
1576,CodeWithHarry,"Object Literals, Constructors and Object Oriented JavaScript | JavaScript Tutorial In Hindi #27",118513,3898,136,2019-07-23,Jul,95,4034
1577,CodeWithHarry,Improving Magic Notes Website Exercise 3 | JavaScript Tutorial In Hindi #26,44993,1490,119,2019-07-22,Jul,75,1609
1578,CodeWithHarry,Creating an Editable Div Exercise 2: Solution | JavaScript Tutorial In Hindi #25,79020,2170,217,2019-07-22,Jul,80,2387
1579,CodeWithHarry,Date Object: Date & Time In JavaScript | JavaScript Tutorial In Hindi #24,71490,2466,54,2019-07-21,Jul,73,2520
1580,CodeWithHarry,Math Object In JavaScript | JavaScript Tutorial In Hindi #23,74795,2647,86,2019-07-21,Jul,60,2733
1581,CodeWithHarry,Project 1: Build a Notes Taking Website Using Pure JavaScript | JavaScript Tutorial In Hindi #22,302319,6170,930,2019-07-20,Jul,96,7100
1582,CodeWithHarry,Creating Editable Div Using JavaScript: Exercise 2 | JavaScript Tutorial In Hindi #21,78870,2367,207,2019-07-20,Jul,85,2574
1583,CodeWithHarry,Local & Session storage in JavaScript | JavaScript Tutorial In Hindi #20,161369,4398,185,2019-07-19,Jul,72,4583
1584,CodeWithHarry,Smart Page Crawler In JS Exercise1: Solution | JavaScript Tutorial In Hindi #19,99869,2887,120,2019-07-19,Jul,79,3007
1585,CodeWithHarry,More on JavaScript Events | JavaScript Tutorial In Hindi #18,98453,3227,134,2019-07-18,Jul,60,3361
1586,CodeWithHarry,Events & Event Object In JavaScript | JavaScript Tutorial In Hindi #17,126311,3788,90,2019-07-18,Jul,70,3878
1587,CodeWithHarry,"Creating, Removing & Replacing Elements | JavaScript Tutorial In Hindi #16",142128,3758,277,2019-07-17,Jul,74,4035
1588,CodeWithHarry,"Children, Parent & Traversing the DOM | JavaScript Tutorial In Hindi #15",151744,4542,153,2019-07-17,Jul,72,4695
1589,CodeWithHarry,HTML Element Selectors In JavaScript | JavaScript Tutorial In Hindi #14,204885,5257,188,2019-07-16,Jul,71,5445
1590,CodeWithHarry,WebPage Crawler In JavaScript - Exercise 1 | JavaScript Tutorial In Hindi #13,143186,3725,798,2019-07-16,Jul,77,4523
1591,CodeWithHarry,Understanding DOM & Creating a Website Layout | JavaScript Tutorial In Hindi #12,270248,7933,376,2019-07-15,Jul,80,8309
1592,CodeWithHarry,Manipulating Websites Using JS Window Object | JavaScript Tutorial In Hindi #11,187771,6223,102,2019-07-15,Jul,79,6325
1593,CodeWithHarry,Functions in JavaScript | JavaScript Tutorial In Hindi #10,226441,5959,184,2019-07-14,Jul,58,6143
1594,CodeWithHarry,"For, While & Do while Loops in JavaScript | JavaScript Tutorial In Hindi #9",194652,5536,156,2019-07-14,Jul,75,5692
1595,CodeWithHarry,If Else Conditionals & Switches in JavaScript | JavaScript Tutorial In Hindi #8,183844,5305,185,2019-07-14,Jul,79,5490
1596,CodeWithHarry,Arrays and Objects In JavaScript | JavaScript Tutorial In Hindi #7,239670,7072,210,2019-07-13,Jul,66,7282
1597,CodeWithHarry,"Strings: Properties, Methods & Template Literals in JavaScript | JavaScript Tutorial In Hindi #6",221648,6582,605,2019-07-13,Jul,96,7187
1598,CodeWithHarry,JavaScript Type Conversion & Coercion | JavaScript Tutorial In Hindi #5,234042,7471,350,2019-07-13,Jul,71,7821
1599,CodeWithHarry,Data Types in JavaScript (Primitive & Reference Types) | JavaScript Tutorial In Hindi #4,268688,8352,280,2019-07-12,Jul,88,8632
1600,CodeWithHarry,"Variables: let, const & var in JavaScript | JavaScript Tutorial In Hindi #3",357937,9899,713,2019-07-12,Jul,75,10612
1601,CodeWithHarry,"Console Logs, Errors, Warnings & More | JavaScript Tutorial In Hindi #2",462319,10650,383,2019-07-11,Jul,71,11033
1602,CodeWithHarry,"Installing VS Code, Extensions & Setup | JavaScript Tutorial In Hindi #1",1142105,23801,3937,2019-07-11,Jul,72,27738
1603,CodeWithHarry,Implementing Google Recaptcha In Python Django (Tutorial),10702,337,77,2019-07-08,Jul,57,414
1604,CodeWithHarry,Python Pandas Tutorial in Hindi,719760,17941,706,2019-07-04,Jul,31,18647
1605,CodeWithHarry,Numpy Tutorial in Hindi,564625,15739,574,2019-07-03,Jul,23,16313
1606,CodeWithHarry,Area of Circle In C Exercise 14 Solution: C Tutorial In Hindi #76,119864,2476,368,2019-07-02,Jul,65,2844
1607,CodeWithHarry,Memory Leak In C: C Tutorial In Hindi #75,52941,1881,98,2019-07-01,Jul,41,1979
1608,CodeWithHarry,Exercise 14 Area of the Circle Using Function Pointers: C Tutorial In Hindi #74,37045,977,59,2019-06-30,Jun,79,1036
1609,CodeWithHarry,Callback Functions Using Function Pointers In C: C Tutorial In Hindi #73,49536,1715,86,2019-06-29,Jun,72,1801
1610,CodeWithHarry,Function Pointers In C: C Tutorial In Hindi #72,65143,2237,72,2019-06-28,Jun,47,2309
1611,CodeWithHarry,Linux Tutorial For Beginners in Hindi,1997043,61987,5690,2019-06-27,Jun,37,67677
1612,CodeWithHarry,[Solved] Command Line Calculator In C Ex.13 : C Tutorial In Hindi #71,32681,1029,68,2019-06-25,Jun,69,1097
1613,CodeWithHarry,Command Line Calculator In C - Exercise 13: C Tutorial In Hindi #70,28529,1024,42,2019-06-23,Jun,67,1066
1614,CodeWithHarry,Automated Bill Generator In C (Solution) - Exercise 12: C Tutorial In Hindi #69,52918,1489,154,2019-06-22,Jun,79,1643
1615,CodeWithHarry,Command Line Arguments In C: C Tutorial In Hindi #68,98616,3416,67,2019-06-21,Jun,52,3483
1616,CodeWithHarry,"File modes, fgets, fputs, fgetc, fputc & more on C file handling: C Tutorial In Hindi #67",215251,6119,271,2019-06-20,Jun,89,6390
1617,CodeWithHarry,Automated Receipt Generator In C - Exercise 12: C Tutorial In Hindi #66,38447,1201,55,2019-06-19,Jun,71,1256
1618,CodeWithHarry,Palindrome Number Program in C Language: C Tutorial In Hindi #65,79457,2081,89,2019-06-17,Jun,64,2170
1619,CodeWithHarry,Functions For File I/O In C Language: C Tutorial In Hindi #64,108642,3598,84,2019-06-16,Jun,61,3682
1620,CodeWithHarry,Check Palindrome In C Language - Exercise 11: C Tutorial In Hindi #63,46107,1418,107,2019-06-15,Jun,69,1525
1621,CodeWithHarry,File I/O In C: C Tutorial In Hindi #62,89433,3586,60,2019-06-14,Jun,38,3646
1622,CodeWithHarry,Matrix Multiplication in C - Exercise 10 Solution: C Tutorial In Hindi #61,116221,3000,112,2019-06-13,Jun,74,3112
1623,CodeWithHarry,Predefined Macros & Other Pre-processor Directives: C Tutorial In Hindi #60,65403,2487,114,2019-06-12,Jun,75,2601
1624,CodeWithHarry,#define and #include Preprocessor Directives: C Tutorial In Hindi #59,77200,2887,121,2019-06-11,Jun,69,3008
1625,CodeWithHarry,Project 2: Coding Flappy Bird Game (With Source Code) | Python Tutorials For Absolute Beginners #122,669080,21655,3210,2019-06-10,Jun,100,24865
1626,CodeWithHarry,C Pre-processor Introduction & Working: C Tutorial In Hindi #58,79876,3012,272,2019-06-09,Jun,63,3284
1627,CodeWithHarry,Matrix Multiplication In C Language - Exercise 10: C Tutorial In Hindi #57,38102,1353,95,2019-06-08,Jun,74,1448
1628,CodeWithHarry,"Rock, Paper & Scissors In C Language - Exercise 9 Solution: C Tutorial In Hindi #56",61191,1821,209,2019-06-08,Jun,83,2030
1629,CodeWithHarry,Wild Pointer In C Language: C Tutorial In Hindi #55,42285,1954,91,2019-06-07,Jun,51,2045
1630,CodeWithHarry,Dangling Pointer In C Language: C Tutorial In Hindi #54,60882,2486,82,2019-06-07,Jun,55,2568
1631,CodeWithHarry,NULL Pointer In C Language: C Tutorial In Hindi #53,62029,2399,51,2019-06-06,Jun,51,2450
1632,CodeWithHarry,Void Pointer In C Language: C Tutorial In Hindi #52,71511,2847,98,2019-06-06,Jun,51,2945
1633,CodeWithHarry,"Coding Rock, Paper, Scissors In C Exercise 9: C Tutorial In Hindi #51",54131,2053,383,2019-06-05,Jun,69,2436
1634,CodeWithHarry,Employee Manager In C - Exercise 8 Solution: C Tutorial In Hindi #50,51187,1691,130,2019-06-05,Jun,68,1821
1635,CodeWithHarry,"Storage Classes In C Auto, Extern, Static & Register Storage Classes: C Tutorial In Hindi #49",141753,4384,108,2019-06-04,Jun,93,4492
1636,CodeWithHarry,C Language Employee Manager Exercise 8: C Tutorial In Hindi #48,54776,1781,140,2019-06-01,Jun,63,1921
1637,CodeWithHarry,Dynamic Memory Allocation Malloc Calloc Realloc & Free(): C Tutorial In Hindi #47,307129,10549,381,2019-05-30,May,81,10930
1638,CodeWithHarry,C Language Travel Agency Manager Exercise 7 Solution: C Tutorial In Hindi #46,70219,2015,205,2019-05-28,May,77,2220
1639,CodeWithHarry,Memory Layout of C Programs - Dynamic Memory Allocation : C Tutorial In Hindi #45,176643,5847,128,2019-05-27,May,81,5975
1640,CodeWithHarry,C Language Travel Agency Manager Exercise 7: C Tutorial In Hindi #44,60526,1966,238,2019-05-26,May,68,2204
1641,CodeWithHarry,C Tutorial HTML Parser Exercise 6: Solution and Shoutouts: C Tutorial In Hindi #43,78705,2275,249,2019-05-25,May,82,2524
1642,CodeWithHarry,Static Variables In C: C Tutorial In Hindi #42,123031,3901,139,2019-05-24,May,46,4040
1643,CodeWithHarry,C Language HTML Parser Exercise 6: C Tutorial In Hindi #41,79231,2298,189,2019-05-22,May,58,2487
1644,CodeWithHarry,C Language Array Reversal Exercise 5: Solution: C Tutorial In Hindi #40,100197,3031,230,2019-05-21,May,71,3261
1645,CodeWithHarry,Unions In C: C Tutorial In Hindi #39,144909,5289,750,2019-05-20,May,36,6039
1646,CodeWithHarry,Typedef In C: C Tutorial In Hindi #38,131405,4900,489,2019-05-19,May,37,5389
1647,CodeWithHarry,Structures In C: C Tutorial In Hindi #37,352771,11554,316,2019-05-19,May,40,11870
1648,CodeWithHarry,Array Reversal In C - Exercise 5: C Tutorial In Hindi #36,92717,2705,308,2019-05-18,May,57,3013
1649,CodeWithHarry,String Functions In C & string.h Library: C Tutorial In Hindi #35,194853,5768,268,2019-05-18,May,65,6036
1650,CodeWithHarry,Strings In C: C Tutorial In Hindi #34,299523,8910,614,2019-05-17,May,37,9524
1651,CodeWithHarry,Star Pattern In C - Exercise 4 Solution: C Tutorial In Hindi #33,114671,3260,125,2019-05-17,May,64,3385
1652,CodeWithHarry,Passing Arrays As Function Arguments: C Tutorial In Hindi #32,195812,5856,240,2019-05-16,May,61,6096
1653,CodeWithHarry,Call by Value & Call By Reference In C: C Tutorial In Hindi #31,262139,7991,604,2019-05-16,May,63,8595
1654,CodeWithHarry,Exercise 4: Printing Star Patterns In C: C Tutorial In Hindi #30,119604,3853,571,2019-05-15,May,64,4424
1655,CodeWithHarry,Is Recursion Always Good? : C Tutorial In Hindi #29,112650,4406,1299,2019-05-15,May,51,5705
1656,CodeWithHarry,Exercise 3 On Recursions: Solution + Shoutouts: C Tutorial In Hindi #28,152516,3879,139,2019-05-14,May,71,4018
1657,CodeWithHarry,Arrays And Pointer Arithmetic In C: C Tutorial In Hindi #27,343437,10869,575,2019-05-13,May,59,11444
1658,CodeWithHarry,C++ Tutorial For Beginners: Learn C Plus Plus In Hindi,2706095,103922,12847,2019-05-12,May,54,116769
1659,CodeWithHarry,Pointers In C: C Tutorial In Hindi #26,579758,20368,483,2019-05-11,May,38,20851
1660,CodeWithHarry,Exercise 3 On Recursions: C Tutorial In Hindi #25,175812,4374,341,2019-05-10,May,49,4715
1661,CodeWithHarry,VS Code Tutorial + Python Setup | Python Tutorials For Absolute Beginners In Hindi #121,814276,31204,2169,2019-05-08,May,87,33373
1662,CodeWithHarry,Exercise 2: Solution + Shoutouts: C Tutorial In Hindi #24,215188,4559,260,2019-05-08,May,57,4819
1663,CodeWithHarry,Arrays In C: C Tutorial In Hindi #23,791904,20846,387,2019-05-07,May,36,21233
1664,CodeWithHarry,C Exercise 2: Units and Conversions: C Tutorial In Hindi #22,197525,5220,801,2019-05-06,May,60,6021
1665,CodeWithHarry,Recursive Functions: Recursion In C: C Tutorial In Hindi #21,488560,14744,534,2019-05-05,May,60,15278
1666,CodeWithHarry,C Exercise 1: Multiplication Table Solution + Shoutouts: C Tutorial In Hindi #20,304052,7284,303,2019-05-05,May,80,7587
1667,CodeWithHarry,Hosting Django Website On Ubuntu VPS | Python Django Tutorials In Hindi #70,54942,1003,181,2019-05-04,May,75,1184
1668,CodeWithHarry,Functions In C: C Tutorial In Hindi #19,760552,19785,988,2019-05-04,May,39,20773
1669,CodeWithHarry,Typecasting In C: C Tutorial In Hindi #18,314190,11113,130,2019-05-03,May,41,11243
1670,CodeWithHarry,Goto Statement In C: C Tutorial In Hindi #17,348518,16167,300,2019-05-02,May,44,16467
1671,CodeWithHarry,Project 1: Iron Man Jarvis AI Desktop Voice Assistant | Python Tutorials For Absolute Beginners #120,3228038,120254,17189,2019-05-01,May,100,137443
1672,CodeWithHarry,Break and Continue Statements In C: C Tutorial In Hindi #16,419734,13777,632,2019-05-01,May,59,14409
1673,CodeWithHarry,For Loop In C: C Tutorial In Hindi #15,510253,17459,798,2019-04-30,Apr,38,18257
1674,CodeWithHarry,While Loop In C: C Tutorial In Hindi #14,384837,14109,261,2019-04-29,Apr,40,14370
1675,CodeWithHarry,Do While Loop In C: C Tutorial In Hindi #13,525328,15459,518,2019-04-29,Apr,43,15977
1676,CodeWithHarry,Loops In C: C Tutorial In Hindi #12,551354,20419,731,2019-04-28,Apr,35,21150
1677,CodeWithHarry,Switch Case Control Statements In C: C Tutorial In Hindi #11,679220,19562,1264,2019-04-28,Apr,60,20826
1678,CodeWithHarry,If Else Control Statements In C: C Tutorial In Hindi #10,828888,23904,2622,2019-04-28,Apr,56,26526
1679,CodeWithHarry,C Format Specifiers and Escape Sequences With Examples : C Tutorial In Hindi #9,777220,23248,667,2019-04-27,Apr,79,23915
1680,CodeWithHarry,C Programming Exercise 1 - Multiplication Tables: C Tutorial In Hindi #8,682218,23008,6423,2019-04-27,Apr,72,29431
1681,CodeWithHarry,Operators In C: C Tutorial In Hindi #7,1132521,31881,1109,2019-04-26,Apr,38,32990
1682,CodeWithHarry,Variables & Data Types In C: C Tutorial In Hindi #6,1101869,41253,1994,2019-04-25,Apr,51,43247
1683,CodeWithHarry,Basic Syntax Of A C Program: C Tutorial In Hindi #5,1081894,38967,3203,2019-04-24,Apr,51,42170
1684,CodeWithHarry,Basic Structure of C Program in Hindi: C Tutorial In Hindi #4,1768530,44869,2218,2019-04-23,Apr,61,47087
1685,CodeWithHarry,Install & Configure VS Code With C Compiler: C Tutorial In Hindi #3,3810808,92236,8719,2019-04-22,Apr,67,100955
1686,CodeWithHarry,What Is Coding & C Programming Language? : C Tutorial In Hindi #2,1577665,78843,3611,2019-04-21,Apr,65,82454
1687,CodeWithHarry,Why Learn C Programming Language? : C Tutorial In Hindi #1,3414503,168504,31337,2019-04-20,Apr,58,199841
1688,CodeWithHarry,Python Problem 9: Jumbled Funny Names | Python Tutorials For Absolute Beginners In Hindi #119,39690,1034,257,2019-04-20,Apr,93,1291
1689,CodeWithHarry,Python Problem 8: Solution | Python Tutorials For Absolute Beginners In Hindi #118,19154,566,51,2019-04-19,Apr,82,617
1690,CodeWithHarry,Python Problem 8: Fake Multiplication Tables | Python Tutorials For Absolute Beginners In Hindi #117,18217,754,176,2019-04-19,Apr,100,930
1691,CodeWithHarry,Python Problem 7: Solution | Python Tutorials For Absolute Beginners In Hindi #116,22313,785,63,2019-04-18,Apr,82,848
1692,CodeWithHarry,Python Problem 7: Creating A Search Engine | Python Tutorials For Absolute Beginners In Hindi #115,41381,1425,146,2019-04-18,Apr,98,1571
1693,CodeWithHarry,Python Problem 6: Solution | Python Tutorials For Absolute Beginners In Hindi #114,15317,600,46,2019-04-17,Apr,82,646
1694,CodeWithHarry,Python Problem 6 | Python Tutorials For Absolute Beginners In Hindi #113,17443,702,257,2019-04-17,Apr,72,959
1695,CodeWithHarry,Python Problem 5: Solution | Python Tutorials For Absolute Beginners In Hindi #112,15446,514,45,2019-04-16,Apr,82,559
1696,CodeWithHarry,Python Problem 5 | Python Tutorials For Absolute Beginners In Hindi #111,17753,735,237,2019-04-16,Apr,72,972
1697,CodeWithHarry,Python Problem 4: Solution | Python Tutorials For Absolute Beginners In Hindi #110,19207,665,70,2019-04-15,Apr,82,735
1698,CodeWithHarry,Python Problem 4 | Python Tutorials For Absolute Beginners In Hindi #109,19930,781,249,2019-04-14,Apr,72,1030
1699,CodeWithHarry,Python Problem 3: Solution | Python Tutorials For Absolute Beginners In Hindi #108,20196,711,73,2019-04-14,Apr,82,784
1700,CodeWithHarry,CSS 3 Tutorial For Beginners: Learn CSS In One Video In Hindi,414516,12862,1143,2019-04-13,Apr,61,14005
1701,CodeWithHarry,Python Practice 3 | Python Tutorials For Absolute Beginners In Hindi #107,21798,910,225,2019-04-12,Apr,73,1135
1702,CodeWithHarry,Python Practice 2 Solution | Python Tutorials For Absolute Beginners In Hindi #106,18882,796,83,2019-04-12,Apr,82,879
1703,CodeWithHarry,Practice Problem 2 (Easy) |  Python Tutorials For Absolute Beginners In Hindi #105,25280,1064,384,2019-04-11,Apr,82,1448
1704,CodeWithHarry,Python Practice 1 Solution | Python Tutorials For Absolute Beginners In Hindi #104,34856,928,76,2019-04-11,Apr,82,1004
1705,CodeWithHarry,Practice Problem 1 (Easy) |  Python Tutorials For Absolute Beginners In Hindi #103,63507,2206,529,2019-04-10,Apr,82,2735
1706,CodeWithHarry,JavaScript Registration Form Validation Tutorial In Hindi - हिंदी में,250156,5948,234,2019-04-09,Apr,69,6182
1707,CodeWithHarry,Reset Forgotten Admin Password In Django| Python Django Tutorials In Hindi #69,27500,600,65,2019-04-09,Apr,78,665
1708,CodeWithHarry,[Solved] gcc is not recognized as an internal or external command operable program or batch file,586186,9103,4417,2019-04-08,Apr,96,13520
1709,CodeWithHarry,C Programming Tutorial For Beginners: Learn C In Hindi,653383,19401,2875,2019-04-08,Apr,54,22276
1710,CodeWithHarry,Login And Registration Form Using Php & MySQL [Php Login System In Hindi],273793,6317,645,2019-04-06,Apr,73,6962
1711,CodeWithHarry,"Create A Responsive Website Using HTML, CSS And Bootstrap 4 In Hindi",136620,4320,283,2019-04-05,Apr,68,4603
1712,CodeWithHarry,Fixing A Bug In Django E Commerce Website Tracker | Python Django Tutorials In Hindi #68,17116,451,76,2019-04-04,Apr,88,527
1713,CodeWithHarry,Creating Product Search Feature In Our E Commerce Website | Python Django Tutorials In Hindi #67,29386,792,119,2019-03-31,Mar,96,911
1714,CodeWithHarry,"Integrating Payment Gateway: PayTM, UPI, Cards & NetBanking | Python Django Tutorials In Hindi #66",117642,2527,615,2019-03-31,Mar,98,3142
1715,CodeWithHarry,"Integrating Facebook Like, Comments & Shares In Django Blog | Python Django Tutorials In Hindi #65",22700,967,135,2019-03-30,Mar,98,1102
1716,CodeWithHarry,Linking Django Blog Posts To Blog Home | Python Django Tutorials In Hindi #64,11137,444,59,2019-03-30,Mar,77,503
1717,CodeWithHarry,jQuery Tutorial For Beginners In Hindi - हिंदी में,485194,14632,801,2019-03-29,Mar,50,15433
1718,CodeWithHarry,Social Networking Website In PHP in 5 Minutes,20124,650,49,2019-03-26,Mar,45,699
1719,CodeWithHarry,Hosting A PHP Website Using DigitalOcean One Click Install On Ubuntu 18 (Linux+Apache+PHP+MySql),3819,49,8,2019-03-25,Mar,96,57
1720,CodeWithHarry,Installing Wordpress On DigitalOcean VPS Droplet (Super Quick),2190,74,15,2019-03-25,Mar,62,89
1721,CodeWithHarry,SSH Keys Deployment Tutorial On Ubuntu 18 VPS In Hindi (Password Free Login),6504,234,34,2019-03-24,Mar,76,268
1722,CodeWithHarry,Putty Tutorial To Connect To A Digitalocean VPS Droplet(Beginner Friendly),7096,146,25,2019-03-24,Mar,74,171
1723,CodeWithHarry,FileZilla Tutorial: Transfer Files Between Client And Remote Server Using SFTP In DigitalOcean,10266,171,40,2019-03-23,Mar,94,211
1724,CodeWithHarry,Important Apache2 Files and Directories For Web Server Administrators! | Apache2 Error/Access Logs,4084,130,19,2019-03-23,Mar,98,149
1725,CodeWithHarry,How to Host Flask App On Ubuntu 18 VPS Using Virtual Environment! (Python Website Hosting),7940,147,31,2019-03-22,Mar,90,178
1726,CodeWithHarry,Hosting Multiple PHP Websites On One Single Ubuntu 18.04 DigitalOcean VPS Using Apache Server,12792,292,40,2019-03-21,Mar,93,332
1727,CodeWithHarry,Git & GitHub Tutorial For Beginners In Hindi - हिंदी में,1932164,64865,2149,2019-03-20,Mar,56,67014
1728,CodeWithHarry,How To Install PHP MyAdmin On Digital Ocean? Linux VPS Setup Guide,9999,245,59,2019-03-06,Mar,66,304
1729,CodeWithHarry,"Installing LAMP (Linux, Apache, MySQL & PHP) Stack On DigitalOcean",19937,521,44,2019-03-05,Mar,66,565
1730,CodeWithHarry,Initial Server Setup Using Digital Ocean On Ubuntu 18 VPS | Creating A Droplet + Sudo User,33637,1085,138,2019-03-03,Mar,90,1223
1731,CodeWithHarry,What is a VPS & How To Use Digital Ocean?,60839,2501,87,2019-03-02,Mar,41,2588
1732,CodeWithHarry,Django Exercise 5: Solution + Shoutouts | Python Django Tutorials In Hindi #63,8357,476,32,2019-03-02,Mar,78,508
1733,CodeWithHarry,Designing The Blog Home Page | Python Django Tutorials In Hindi #62,13378,500,68,2019-03-01,Mar,67,568
1734,CodeWithHarry,Creating a Django Post Page For Displaying Blog Content | Python Django Tutorials In Hindi #61,13840,394,49,2019-03-01,Mar,94,443
1735,CodeWithHarry,Django Exercise 5: BlogPosts | Python Django Tutorials In Hindi #60,10404,383,44,2019-02-28,Feb,67,427
1736,CodeWithHarry,Creating Models For Blog In Our E-Commerce Website | Python Django Tutorials In Hindi #59,14790,400,35,2019-02-28,Feb,89,435
1737,CodeWithHarry,My Awesome Cart: Creating The Blog | Python Django Tutorials In Hindi #58,18152,480,20,2019-02-27,Feb,73,500
1738,CodeWithHarry,How To Create A Currency Converter In Python? | Python Programming Practice (Hindi),63505,1608,136,2019-02-27,Feb,83,1744
1739,CodeWithHarry,How To Create A Python HTTP Server For Web Development?,59492,1632,88,2019-02-26,Feb,55,1720
1740,CodeWithHarry,Django Website My Awesome Cart: Pull Requests | Python Django Tutorials In Hindi #57,14550,402,40,2019-02-26,Feb,84,442
1741,CodeWithHarry,How To Find Factorial & No Of Trailing Zeros In A Factorial Of A Number In Python?,48275,1754,287,2019-02-25,Feb,82,2041
1742,CodeWithHarry,Django Website TextUtils: Pull Requests | Python Django Tutorials In Hindi #56,11091,374,30,2019-02-25,Feb,78,404
1743,CodeWithHarry,How to Create An Indian Kirana Store Calculator & Receipt Generator In Basic Python?,225748,7397,1075,2019-02-24,Feb,84,8472
1744,CodeWithHarry,Merging Blog App Into The Shop UI | Python Django Tutorials In Hindi #55,17675,669,84,2019-02-24,Feb,72,753
1745,CodeWithHarry,Django Solution To Exercise 4: Display Prices  | Python Django Tutorials In Hindi #54,17020,520,80,2019-02-23,Feb,85,600
1746,CodeWithHarry,E-Commerce Website: Displaying Order Items In Tracker | Python Django Tutorials In Hindi #53,20899,625,75,2019-02-23,Feb,92,700
1747,CodeWithHarry,Django Exercise 4: Display Prices | Python Django Tutorials In Hindi #52,14615,660,81,2019-02-22,Feb,72,741
1748,CodeWithHarry,Creating Order Tracker For Customers | Python Django Tutorials In Hindi #51,40399,1305,226,2019-02-22,Feb,75,1531
1749,CodeWithHarry,Creating Database Entry For Orders | Python Django Tutorials In Hindi #50,29897,1219,147,2019-02-21,Feb,73,1366
1750,CodeWithHarry,Adding Items On Checkout Page | Python Django Tutorials In Hindi #49,26832,1091,227,2019-02-21,Feb,68,1318
1751,CodeWithHarry,Creating The Checkout Page | Python Django Tutorials In Hindi #48,24291,928,71,2019-02-20,Feb,65,999
1752,CodeWithHarry,Adding Checkout & ClearCart Buttons | Python Django Tutorials In Hindi #47,25858,870,323,2019-02-20,Feb,74,1193
1753,CodeWithHarry,Exercise 3: Solutions + Shoutouts | Python Django Tutorials In Hindi #46,15855,1202,59,2019-02-19,Feb,72,1261
1754,CodeWithHarry,Creating A Cart In Navigation Bar As Popover | Python Django Tutorials In Hindi #45,27817,815,96,2019-02-19,Feb,83,911
1755,CodeWithHarry,Creating Add and Remove Buttons For Items In Cart | Python Django Tutorials In Hindi #44,43476,1148,226,2019-02-18,Feb,88,1374
1756,CodeWithHarry,Exercise 3: Improving Cart Of Our E commerce Website | Python Django Tutorials In Hindi #43,23414,979,95,2019-02-18,Feb,91,1074
1757,CodeWithHarry,E Commerce Website: Creating Contact Page + Database | Python Django Tutorials In Hindi #42,38651,1178,114,2019-02-17,Feb,91,1292
1758,CodeWithHarry,E Commerce Website: Creating Product Page | Python Django Tutorials In Hindi #41,46802,1538,168,2019-02-17,Feb,80,1706
1759,CodeWithHarry,Adding Cart PopOver & Other Pages Using Bootstrap | Python Django Tutorials In Hindi #40,39067,1515,132,2019-02-16,Feb,88,1647
1760,CodeWithHarry,Adding Bootstrap Row & Some CSS | Python Django Tutorials In Hindi #39,30063,1373,86,2019-02-16,Feb,70,1459
1761,CodeWithHarry,Improving Slider Logic & Adding Cart Items Count | Python Django Tutorials In Hindi #38,41313,1358,115,2019-02-15,Feb,87,1473
1762,CodeWithHarry,Exercise 3: Solution + Shoutouts | Python Django Tutorials In Hindi #37,26410,963,274,2019-02-15,Feb,71,1237
1763,CodeWithHarry,Creating an Online Shopping Cart Using JavaScript | Python Django Tutorials In Hindi #36,63841,1571,245,2019-02-14,Feb,88,1816
1764,CodeWithHarry,Category-Wise Product Display In E Commerce Website | Python Django Tutorials In Hindi #35,53801,1315,230,2019-02-14,Feb,90,1545
1765,CodeWithHarry,Showing Multiple Product Slides On Homepage | Python Django Tutorials In Hindi #34,59448,1466,131,2019-02-13,Feb,82,1597
1766,CodeWithHarry,Showing Products On The Homepage | Python Django Tutorials In Hindi #33,87463,1876,392,2019-02-13,Feb,71,2268
1767,CodeWithHarry,Logic For Showing Products On Homepage | Python Django Tutorials In Hindi #32,56162,2016,140,2019-02-12,Feb,77,2156
1768,CodeWithHarry,Template Inheritance In Django | Python Django Tutorials In Hindi #31,71446,2480,325,2019-02-12,Feb,69,2805
1769,CodeWithHarry,Fetching Products Using Python manage.py shell | Python Django Tutorials In Hindi #30,65310,1651,87,2019-02-11,Feb,85,1738
1770,CodeWithHarry,Django Exercise 3: List the Products | Python Django Tutorials In Hindi #29,54469,1564,123,2019-02-11,Feb,75,1687
1771,CodeWithHarry,Adding Media Directory In Django | Python Django Tutorials In Hindi #28,77400,1964,168,2019-02-10,Feb,71,2132
1772,CodeWithHarry,Adding Images & Changing Models In Django | Python Django Tutorials In Hindi #27,96420,2184,210,2019-02-10,Feb,80,2394
1773,CodeWithHarry,Designing The Homepage Of Our E-Commerce Website | Python Django Tutorials In Hindi #26,124962,3009,333,2019-02-09,Feb,87,3342
1774,CodeWithHarry,Django Admin & Adding Data To The Database | Python Django Tutorials In Hindi #25,104934,3287,297,2019-02-09,Feb,81,3584
1775,CodeWithHarry,Models In Our Django E commerce Website | Python Django Tutorials In Hindi #24,118732,4650,183,2019-02-08,Feb,78,4833
1776,CodeWithHarry,E-commerce Website: Project Layout | Python Django Tutorials In Hindi #23,89069,2266,196,2019-02-08,Feb,73,2462
1777,CodeWithHarry,"E-commerce Website: Adding Bootstrap, Templates & Static | Python Django Tutorials In Hindi #22",122050,3314,523,2019-02-07,Feb,95,3837
1778,CodeWithHarry,E-commerce Website: Creating Apps (Apps Vs Projects) | Python Django Tutorials In Hindi #21,120533,4382,420,2019-02-07,Feb,91,4802
1779,CodeWithHarry,E Commerce Website In Django (Project Setup) | Python Django Tutorials In Hindi #20,117920,2596,182,2019-02-06,Feb,83,2778
1780,CodeWithHarry,Our Next Django Website | Python Django Tutorials In Hindi #19,75480,2537,152,2019-02-06,Feb,62,2689
1781,CodeWithHarry,Wrapping Up TextUtils Website | Python Django Tutorials In Hindi #18,52339,2750,238,2019-02-05,Feb,68,2988
1782,CodeWithHarry,Exercise 2 Solution + Shoutouts  | Python Django Tutorials In Hindi #17,45988,1817,167,2019-02-05,Feb,71,1984
1783,CodeWithHarry,Django CSRF Tokens & Post Request | Python Django Tutorials In Hindi #16,73641,1892,135,2019-02-04,Feb,72,2027
1784,CodeWithHarry,Fixing Bugs In Our TextUtils Website | Python Django Tutorials In Hindi #15,54801,2667,274,2019-02-04,Feb,75,2941
1785,CodeWithHarry,Adding Boostrap To Our Django Website | Python Django Tutorials In Hindi #14,90157,2234,214,2019-02-03,Feb,76,2448
1786,CodeWithHarry,Django Exercise 2: Revamping TextUtils | Python Django Tutorials In Hindi #13,55593,1989,209,2019-02-03,Feb,77,2198
1787,CodeWithHarry,HTML 5 Tutorial For Beginners In Hindi - हिंदी में (2021),580056,24888,7494,2019-02-02,Feb,57,32382
1788,CodeWithHarry,Adding More Features To TextUtils Website | Python Django Tutorials In Hindi #12,92675,2864,960,2019-02-02,Feb,80,3824
1789,CodeWithHarry,Django Exercise 1 Solution + Shoutouts | Python Django Tutorials In Hindi #11,77954,1643,108,2019-02-01,Feb,77,1751
1790,CodeWithHarry,Django Site: Coding The Backend | Python Django Tutorials In Hindi #10,156365,5545,866,2019-02-01,Feb,70,6411
1791,CodeWithHarry,Creating Homepage of our TextUtils Website | Python Django Tutorials In Hindi #9,155711,5529,818,2019-01-31,Jan,80,6347
1792,CodeWithHarry,Django Templates | Python Django Tutorials In Hindi #8,175136,6544,425,2019-01-31,Jan,54,6969
1793,CodeWithHarry,Django Website: Laying The Pipeline | Python Django Tutorials In Hindi #7,157139,8944,497,2019-01-30,Jan,73,9441
1794,CodeWithHarry,Django Exercise 1: Personal Navigator | Python Django Tutorials In Hindi #6,172479,4976,1313,2019-01-30,Jan,75,6289
1795,CodeWithHarry,Views & Urls In Django| Python Django Tutorials In Hindi #5,263131,4768,666,2019-01-29,Jan,59,5434
1796,CodeWithHarry,Our First Django Website | Python Django Tutorials In Hindi #4,259477,4907,176,2019-01-29,Jan,62,5083
1797,CodeWithHarry,How Django Websites Work | Python Django Tutorials In Hindi #3,219545,5384,378,2019-01-28,Jan,62,5762
1798,CodeWithHarry,Creating Our First Django Project | Python Django Tutorials In Hindi #2,425730,8338,1393,2019-01-28,Jan,71,9731
1799,CodeWithHarry,Django Installation & Getting Started | Python Django Tutorials In Hindi #1,425460,9372,726,2019-01-27,Jan,75,10098
1800,CodeWithHarry,Django Course Announcement | Python Django Tutorials In Hindi #0,716100,29234,7961,2019-01-27,Jan,64,37195
1801,CodeWithHarry,Tkinter Tutorials Conclusion + Resources | Python Tkinter GUI Tutorial In Hindi #30,33275,1696,809,2019-01-26,Jan,83,2505
1802,CodeWithHarry,Creating a GUI Notepad In Tkinter | Python Tkinter GUI Tutorial In Hindi #29,73843,1774,372,2019-01-26,Jan,76,2146
1803,CodeWithHarry,Tkinter GUI Text Editor Announcement | Python Tkinter GUI Tutorial In Hindi #28,20472,664,46,2019-01-25,Jan,79,710
1804,CodeWithHarry,Creating A Calculator Using Tkinter  | Python Tkinter GUI Tutorial In Hindi #27,134504,2877,299,2019-01-25,Jan,79,3176
1805,CodeWithHarry,"More Tkinter Tips, Tricks & Functions | Python Tkinter GUI Tutorial In Hindi #26",23554,1141,124,2019-01-24,Jan,80,1265
1806,CodeWithHarry,Using Classes And Objects To Create GUIs | Python Tkinter GUI Tutorial In Hindi #25,32209,1338,164,2019-01-24,Jan,83,1502
1807,CodeWithHarry,Status Bar In Tkinter | Python Tkinter GUI Tutorial In Hindi #24,25127,1427,161,2019-01-23,Jan,64,1588
1808,CodeWithHarry,Tkinter GUI Exercise 2 Solution + Shoutouts | Python Tkinter GUI Tutorial In Hindi #23,17574,756,64,2019-01-23,Jan,86,820
1809,CodeWithHarry,ScrollBar In Tkinter GUI | Python Tkinter GUI Tutorial In Hindi #22,35056,1430,134,2019-01-22,Jan,67,1564
1810,CodeWithHarry,ListBox In Tkinter| Python Tkinter GUI Tutorial In Hindi #21,28300,2208,65,2019-01-22,Jan,60,2273
1811,CodeWithHarry,Creating RadioButtons In Tkinter | Python Tkinter GUI Tutorial In Hindi #20,32881,1980,161,2019-01-21,Jan,75,2141
1812,CodeWithHarry,Sliders In Tkinter Using Scale() | Python Tkinter GUI Tutorial In Hindi #19,32874,1396,356,2019-01-21,Jan,75,1752
1813,CodeWithHarry,Message Box In Tkinter Python | Python Tkinter GUI Tutorial In Hindi #18,41607,1876,212,2019-01-20,Jan,72,2088
1814,CodeWithHarry,Menus & Submenus In Tkinter Python | Python Tkinter GUI Tutorial In Hindi #17,52832,2390,258,2019-01-20,Jan,77,2648
1815,CodeWithHarry,Python GUI Exercise 2: Window Resizer GUI | Python Tkinter GUI Tutorial In Hindi #16,26443,1051,435,2019-01-19,Jan,84,1486
1816,CodeWithHarry,Python GUI Exercise 1: Solution | Python Tkinter GUI Tutorial In Hindi #15,44504,1492,119,2019-01-19,Jan,74,1611
1817,CodeWithHarry,Handling Events In Tkinter GUI | Python Tkinter GUI Tutorial In Hindi #14,48943,2408,299,2019-01-18,Jan,73,2707
1818,CodeWithHarry,Canvas Widget In Python Tkinter | Python Tkinter GUI Tutorial In Hindi #13,57015,2353,178,2019-01-18,Jan,74,2531
1819,CodeWithHarry,Accepting User Input In Tkinter Form | Python Tkinter GUI Tutorial In Hindi #12,69468,2039,189,2019-01-17,Jan,79,2228
1820,CodeWithHarry,Travel Form Using Checkbuttons & Entry Widget | Python Tkinter GUI Tutorial In Hindi #11,70850,2878,395,2019-01-17,Jan,88,3273
1821,CodeWithHarry,Entry Widget & Grid Layout In Tkinter | Python Tkinter GUI Tutorial In Hindi #10,85531,2283,329,2019-01-16,Jan,80,2612
1822,CodeWithHarry,Conclusion & Way Forward | Python Tutorials For Absolute Beginners In Hindi #102,32215,2910,1928,2019-01-16,Jan,80,4838
1823,CodeWithHarry,Mini Project 1 (OOPs Library) Solution | Python Tutorials For Absolute Beginners In Hindi #101,82180,2082,142,2019-01-15,Jan,94,2224
1824,CodeWithHarry,Regex Exercise 11 Solutions | Python Tutorials For Absolute Beginners In Hindi #100,25024,983,42,2019-01-15,Jan,83,1025
1825,CodeWithHarry,Machine Learning & Data Science Learning Path | Python Tutorials For Absolute Beginners In Hindi #99,50462,2322,162,2019-01-14,Jan,100,2484
1826,CodeWithHarry,Python GUI Development - Learning Path | Python Tutorials For Absolute Beginners In Hindi #98,64677,2861,274,2019-01-14,Jan,93,3135
1827,CodeWithHarry,Learning Path For Python Web Development | Python Tutorials For Absolute Beginners In Hindi #97,147569,4870,442,2019-01-13,Jan,95,5312
1828,CodeWithHarry,Python Exercise 11: Regex Email Extractor | Python Tutorials For Absolute Beginners In Hindi #96,28626,1120,189,2019-01-13,Jan,96,1309
1829,CodeWithHarry,Creating a Python Package Using Setuptools | Python Tutorials For Absolute Beginners In Hindi #95,84591,2996,271,2019-01-12,Jan,97,3267
1830,CodeWithHarry,Packing Buttons In Tkinter | Python Tkinter GUI Tutorial In Hindi #9,83514,2767,512,2019-01-12,Jan,68,3279
1831,CodeWithHarry,Exercise 10: Solution + Shoutouts | Python Tutorials For Absolute Beginners In Hindi #94,25536,924,45,2019-01-11,Jan,88,969
1832,CodeWithHarry,Creating a Command Line Utility In Python | Python Tutorials For Absolute Beginners In Hindi #93,65899,3208,394,2019-01-11,Jan,96,3602
1833,CodeWithHarry,Frame In Tkinter | Python Tkinter GUI Tutorial In Hindi #8,105792,3811,156,2019-01-10,Jan,58,3967
1834,CodeWithHarry,Python Exercise 9 Solution + Shoutouts | Python Tutorials For Absolute Beginners In Hindi #92,36735,1424,132,2019-01-10,Jan,93,1556
1835,CodeWithHarry,Python 2.x Vs Python 3.x | Python Tutorials For Absolute Beginners In Hindi #91,33630,1923,147,2019-01-09,Jan,79,2070
1836,CodeWithHarry,Exercise 1: Creating Newspaper GUI | Python Tkinter GUI Tutorial In Hindi #7,75469,3001,318,2019-01-09,Jan,76,3319
1837,CodeWithHarry,Python 'is' vs '==': What's The Difference? | Python Tutorials For Absolute Beginners In Hindi #90,37289,2083,438,2019-01-08,Jan,98,2521
1838,CodeWithHarry,Attributes Of Label & Pack | Python Tkinter GUI Tutorial In Hindi #6,135389,4661,889,2019-01-08,Jan,68,5550
1839,CodeWithHarry,Raise In Python + Examples | Python Tutorials For Absolute Beginners In Hindi #89,48387,2470,523,2019-01-07,Jan,81,2993
1840,CodeWithHarry,Python Exercise 8: Solution + Tips | Python Tutorials For Absolute Beginners In Hindi #88,37280,2135,126,2019-01-07,Jan,89,2261
1841,CodeWithHarry,Converting .py to .exe | Python Tutorials For Absolute Beginners In Hindi #87,199175,6146,875,2019-01-06,Jan,77,7021
1842,CodeWithHarry,Displaying Images Using Label | Python Tkinter GUI Tutorial In Hindi #5,186079,5804,858,2019-01-06,Jan,71,6662
1843,CodeWithHarry,Regular Expressions | Python Tutorials For Absolute Beginners In Hindi #86,171858,4800,436,2019-01-06,Jan,74,5236
1844,CodeWithHarry,Exercise 10: Pickling Iris | Python Tutorials For Absolute Beginners In Hindi #85,37639,1690,222,2019-01-05,Jan,81,1912
1845,CodeWithHarry,"Label, Geometry, Maxsize & Minsize | Python Tkinter GUI Tutorial In Hindi #4",160819,6203,1526,2019-01-05,Jan,76,7729
1846,CodeWithHarry,Tkinter Widgets & Attributes | Python Tkinter GUI Tutorial In Hindi #3,150772,5800,754,2019-01-05,Jan,70,6554
1847,CodeWithHarry,Pickle Module | Python Tutorials For Absolute Beginners In Hindi #84,95361,3561,246,2019-01-05,Jan,68,3807
1848,CodeWithHarry,Exercise 9: Akhbaar Padhke Sunaao | Python Tutorials For Absolute Beginners In Hindi #83,71772,2117,287,2019-01-04,Jan,88,2404
1849,CodeWithHarry,Our First Tkinter GUI | Python Tkinter GUI Tutorial In Hindi #2,205514,7306,1677,2019-01-04,Jan,63,8983
1850,CodeWithHarry,Json Module | Python Tutorials For Absolute Beginners In Hindi #82,99462,3202,529,2019-01-04,Jan,66,3731
1851,CodeWithHarry,Requests Module For HTTP Requests | Python Tutorials For Absolute Beginners In Hindi #81,94911,2833,169,2019-01-03,Jan,88,3002
1852,CodeWithHarry,Notepad & Calculator In Tkinter + Why Tkinter? | Python Tkinter GUI Tutorial In Hindi #1,221060,9142,779,2019-01-03,Jan,88,9921
1853,CodeWithHarry,Exercise 8: Oh Soldier Prettify My Folder| Python Tutorials For Absolute Beginners In Hindi #80,51269,2022,387,2019-01-03,Jan,95,2409
1854,CodeWithHarry,Os Module | Python Tutorials For Absolute Beginners In Hindi #79,125097,4632,251,2019-01-02,Jan,64,4883
1855,CodeWithHarry,Exercise 7: Solution & First Solver | Python Tutorials For Absolute Beginners In Hindi #78,76057,2148,473,2019-01-02,Jan,90,2621
1856,CodeWithHarry,Learn Tkinter With Projects | Python Tkinter GUI Tutorial In Hindi #0,350417,13708,3332,2019-01-01,Jan,69,17040
1857,CodeWithHarry,Coroutines In Python | Python Tutorials For Absolute Beginners In Hindi #77,73012,3061,497,2019-01-01,Jan,75,3558
1858,CodeWithHarry,Else & Finally In Try Except | Python Tutorials For Absolute Beginners In Hindi #76,57931,3029,236,2019-01-01,Jan,83,3265
1859,CodeWithHarry,Making Python Say Happy New Year In 58 Different Languages,37076,1440,224,2018-12-31,Dec,58,1664
1860,CodeWithHarry,Function Caching In Python | Python Tutorials For Absolute Beginners In Hindi #75,65906,3925,352,2018-12-31,Dec,81,4277
1861,CodeWithHarry,Using Else With For Loops | Python Tutorials For Absolute Beginners In Hindi #74,56646,3212,922,2018-12-31,Dec,80,4134
1862,CodeWithHarry,Python Comprehensions | Python Tutorials For Absolute Beginners In Hindi #73,112434,4074,424,2018-12-30,Dec,76,4498
1863,CodeWithHarry,Generators In Python | Python Tutorials For Absolute Beginners In Hindi #72,110792,4155,348,2018-12-30,Dec,75,4503
1864,CodeWithHarry,Python Mini Project #1 | Python Tutorials For Absolute Beginners In Hindi #71,97583,2985,526,2018-12-29,Dec,77,3511
1865,CodeWithHarry,Object Introspection | Python Tutorials For Absolute Beginners In Hindi #70,66721,3127,263,2018-12-29,Dec,75,3390
1866,CodeWithHarry,Setters & Property Decorators | Python Tutorials For Absolute Beginners In Hindi #69,113920,4379,451,2018-12-28,Dec,84,4830
1867,CodeWithHarry,Abstract Base Class & @abstractmethod | Python Tutorials For Absolute Beginners In Hindi #68,98336,4109,112,2018-12-28,Dec,92,4221
1868,CodeWithHarry,Operator Overloading & Dunder Methods | Python Tutorials For Absolute Beginners In Hindi #67,105851,3868,202,2018-12-27,Dec,92,4070
1869,CodeWithHarry,Diamond Shape Problem In Multiple Inheritance | Python Tutorials For Absolute Beginners In Hindi #66,79081,3727,99,2018-12-27,Dec,100,3826
1870,CodeWithHarry,Polymorphism In Python | Python Tutorials For Absolute Beginners In Hindi #64,109670,4243,297,2018-12-26,Dec,77,4540
1871,CodeWithHarry,Super() and Overriding In Classes | Python Tutorials For Absolute Beginners In Hindi #65,121922,4504,182,2018-12-26,Dec,88,4686
1872,CodeWithHarry,"Public, Private & Protected Access Specifiers | Python Tutorials For Absolute Beginners In Hindi #63",103423,4448,124,2018-12-26,Dec,100,4572
1873,CodeWithHarry,Multilevel Inheritance | Python Tutorials For Absolute Beginners In Hindi #62,84290,4465,787,2018-12-25,Dec,77,5252
1874,CodeWithHarry,Multiple Inheritance | Python Tutorials For Absolute Beginners In Hindi #61,104278,4351,182,2018-12-25,Dec,75,4533
1875,CodeWithHarry,Single Inheritance | Python Tutorials For Absolute Beginners In Hindi #60,139511,5371,732,2018-12-24,Dec,73,6103
1876,CodeWithHarry,Abstraction & Encapsulation | Python Tutorials For Absolute Beginners In Hindi #59,172442,6257,220,2018-12-24,Dec,82,6477
1877,CodeWithHarry,Static Methods In Python | Python Tutorials For Absolute Beginners In Hindi #58,130471,4804,146,2018-12-23,Dec,79,4950
1878,CodeWithHarry,Class Methods As Alternative Constructors | Python Tutorials For Absolute Beginners In Hindi #57,155638,7783,206,2018-12-23,Dec,96,7989
1879,CodeWithHarry,Class Methods In Python | Python Tutorials For Absolute Beginners In Hindi #56,202986,6623,210,2018-12-22,Dec,78,6833
1880,CodeWithHarry,Self & __init__() (Constructors) | Python Tutorials For Absolute Beginners In Hindi #55,315669,9113,278,2018-12-22,Dec,87,9391
1881,CodeWithHarry,Instance & Class Variables | Python Tutorials For Absolute Beginners In Hindi #54,216456,8493,169,2018-12-21,Dec,81,8662
1882,CodeWithHarry,Creating Our First Class In Python | Python Tutorials For Absolute Beginners In Hindi #53,218123,7411,133,2018-12-21,Dec,89,7544
1883,CodeWithHarry,Classes & Objects (OOPS) | Python Tutorials For Absolute Beginners In Hindi #52,397177,12633,243,2018-12-20,Dec,79,12876
1884,CodeWithHarry,Decorators In Python | Python Tutorials For Absolute Beginners In Hindi #51,229833,7590,383,2018-12-20,Dec,75,7973
1885,CodeWithHarry,Exercise 7: Healthy Programmer | Python Tutorials For Absolute Beginners In Hindi #50,105973,4445,453,2018-12-19,Dec,85,4898
1886,CodeWithHarry,Exercise 6 Solution & First Solver | Python Tutorials For Absolute Beginners In Hindi #49,103435,2858,286,2018-12-19,Dec,89,3144
1887,CodeWithHarry,"Map, Filter & Reduce | Python Tutorials For Absolute Beginners In Hindi #48",231231,12602,1456,2018-12-18,Dec,75,14058
1888,CodeWithHarry,Join Function In Python | Python Tutorials For Absolute Beginners In Hindi #47,122050,6481,146,2018-12-18,Dec,78,6627
1889,CodeWithHarry,If __name__==__main__ usage & necessity | Python Tutorials For Absolute Beginners In Hindi #46,218465,13230,302,2018-12-17,Dec,94,13532
1890,CodeWithHarry,How Import Works In Python? | Python Tutorials For Absolute Beginners In Hindi #45,176285,6963,234,2018-12-17,Dec,82,7197
1891,CodeWithHarry,Enumerate Function | Python Tutorials For Absolute Beginners In Hindi #44,161398,7672,206,2018-12-16,Dec,73,7878
1892,CodeWithHarry,Virtual Environment & Requirements.txt | Python Tutorials For Absolute Beginners In Hindi #43,291118,11334,1470,2018-12-16,Dec,93,12804
1893,CodeWithHarry,Time Module In Python | Python Tutorials For Absolute Beginners In Hindi #42,185530,9610,286,2018-12-15,Dec,76,9896
1894,CodeWithHarry,*args and **kwargs In Python | Python Tutorials For Absolute Beginners In Hindi #41,239662,9553,405,2018-12-15,Dec,83,9958
1895,CodeWithHarry,Exercise 6: Game Development: Snake Water Gun | Python Tutorials For Absolute Beginners In Hindi #40,170490,6863,1896,2018-12-14,Dec,100,8759
1896,CodeWithHarry,F-Strings & String Formatting In Python | Python Tutorials For Absolute Beginners In Hindi #39,195498,8126,171,2018-12-14,Dec,94,8297
1897,CodeWithHarry,Using Python External & Built In Modules | Python Tutorials For Absolute Beginners In Hindi #38,217674,9229,816,2018-12-13,Dec,95,10045
1898,CodeWithHarry,Exercise 5: Solution And First Solver | Python Tutorials For Absolute Beginners In Hindi #37,162870,4567,364,2018-12-13,Dec,92,4931
1899,CodeWithHarry,Anonymous/Lambda Functions In Python | Python Tutorials For Absolute Beginners In Hindi #36,245498,14140,220,2018-12-12,Dec,91,14360
1900,CodeWithHarry,Exercise 4: Solution And First Solver | Python Tutorials For Absolute Beginners In Hindi #35,166588,4561,485,2018-12-12,Dec,92,5046
1901,CodeWithHarry,Recursions: Recursive Vs Iterative Approach | Python Tutorials For Absolute Beginners In Hindi #34,284726,14650,925,2018-12-11,Dec,98,15575
1902,CodeWithHarry,"Scope, Global Variables and Global Keyword | Python Tutorials For Absolute Beginners In Hindi #33",272484,14328,677,2018-12-11,Dec,97,15005
1903,CodeWithHarry,Exercise 5: Health Management System | Python Tutorials For Absolute Beginners In Hindi #32,243322,5619,1063,2018-12-10,Dec,91,6682
1904,CodeWithHarry,Using With Block To Open Python Files | Python Tutorials For Absolute Beginners In Hindi #31,201332,6068,1016,2018-12-10,Dec,92,7084
1905,CodeWithHarry,"Seek(), tell() & More On Python Files | Python Tutorials For Absolute Beginners In Hindi #30",250967,8027,1012,2018-12-09,Dec,92,9039
1906,CodeWithHarry,Python Exercise 4: Astrologer's Stars | Python Tutorials For Absolute Beginners In Hindi #29,231395,6099,2269,2018-12-09,Dec,92,8368
1907,CodeWithHarry,Writing And Appending To A File | Python Tutorials For Absolute Beginners In Hindi #28,274042,9197,260,2018-12-08,Dec,86,9457
1908,CodeWithHarry,Python Exercise 3: Solution | Python Tutorials For Absolute Beginners In Hindi #27,252999,5496,948,2018-12-08,Dec,82,6444
1909,CodeWithHarry,"Open(), Read() & Readline() For Reading File | Python Tutorials For Absolute Beginners In Hindi #26",410319,12425,589,2018-12-07,Dec,99,13014
1910,CodeWithHarry,Python File IO Basics | Python Tutorials For Absolute Beginners In Hindi #25,335640,9964,2709,2018-12-07,Dec,76,12673
1911,CodeWithHarry,Try Except Exception Handling In Python | Python Tutorials For Absolute Beginners In Hindi #24,361961,12026,274,2018-12-06,Dec,94,12300
1912,CodeWithHarry,Functions And Docstrings | Python Tutorials For Absolute Beginners In Hindi #23,478827,17249,503,2018-12-06,Dec,79,17752
1913,CodeWithHarry,Short Hand If Else Notation In Python | Python Tutorials For Absolute Beginners In Hindi #22,244633,10128,194,2018-12-05,Dec,92,10322
1914,CodeWithHarry,Operators In Python | Python Tutorials For Absolute Beginners In Hindi #21,361292,12242,409,2018-12-04,Dec,74,12651
1915,CodeWithHarry,Python Exercise 3 - Guess The Number | Python Tutorials For Absolute Beginners In Hindi #20,288428,7801,4055,2018-12-04,Dec,91,11856
1916,CodeWithHarry,Python Exercise 2: Faulty Calculator Solution| Python Tutorials For Absolute Beginners In Hindi #19,331228,7476,1253,2018-12-03,Dec,99,8729
1917,CodeWithHarry,Break & Continue Statements In Python | Python Tutorials For Absolute Beginners In Hindi #18,419665,13983,2126,2018-12-03,Dec,92,16109
1918,CodeWithHarry,While Loops In Python | Python Tutorials For Absolute Beginners In Hindi #17,417331,12709,329,2018-12-02,Dec,76,13038
1919,CodeWithHarry,For Loops In Python | Python Tutorials For Absolute Beginners In Hindi #16,778905,23136,1354,2018-12-02,Dec,74,24490
1920,CodeWithHarry,Python Exercise 2 - Faulty Calculator  | Python Tutorials For Absolute Beginners In Hindi #15,374910,11341,3931,2018-12-01,Dec,93,15272
1921,CodeWithHarry,Exercise 1 - Solution And Your Answers | Python Tutorials For Absolute Beginners In Hindi #14,381865,8942,862,2018-12-01,Dec,93,9804
1922,CodeWithHarry,If Else & Elif Conditionals In Python | Python Tutorials For Absolute Beginners In Hindi #13,651928,19460,5110,2018-11-30,Nov,92,24570
1923,CodeWithHarry,Sets In Python | Python Tutorials For Absolute Beginners In Hindi #12,519015,15512,586,2018-11-30,Nov,69,16098
1924,CodeWithHarry,Python Exercise 1 - Apni Dictionary | Python Tutorials For Absolute Beginners In Hindi #11,488543,10756,4338,2018-11-29,Nov,90,15094
1925,CodeWithHarry,Dictionary & Its Functions Explained | Python Tutorials For Absolute Beginners In Hindi #10,786220,30292,1756,2018-11-29,Nov,91,32048
1926,CodeWithHarry,Python Lists And List Functions | Python Tutorials For Absolute Beginners In Hindi #9,1015904,55770,3345,2018-11-28,Nov,85,59115
1927,CodeWithHarry,String Slicing And Other Functions In Python | Python Tutorials For Absolute Beginners In Hindi #8,1020097,41980,2640,2018-11-28,Nov,98,44620
1928,CodeWithHarry,"Variables, Datatypes and Typecasting | Python Tutorials For Absolute Beginners In Hindi #7",1104430,46522,4778,2018-11-27,Nov,90,51300
1929,CodeWithHarry,"Comments, Escape Sequences & Print Statement| Python Tutorials For Absolute Beginners In Hindi #6",1046587,42458,2102,2018-11-27,Nov,97,44560
1930,CodeWithHarry,Using Python As A Calculator | Python Tutorials For Absolute Beginners In Hindi #5,843148,26523,521,2018-11-26,Nov,82,27044
1931,CodeWithHarry,Writing Our First Python Program | Python Tutorials For Absolute Beginners In Hindi #4,1044067,35674,1092,2018-11-26,Nov,86,36766
1932,CodeWithHarry,Using Modules & Pip In Python | Python Tutorials For Absolute Beginners In Hindi #3,1270560,36477,1363,2018-11-25,Nov,83,37840
1933,CodeWithHarry,Downloading Python and Pycharm Installation | Python Tutorials For Absolute Beginners In Hindi #2,2414811,58170,4671,2018-11-25,Nov,97,62841
1934,CodeWithHarry,What is Programming & Why Learn Python? | Python Tutorials For Absolute Beginners In Hindi #1,1509450,52277,1378,2018-11-25,Nov,93,53655
1935,CodeWithHarry,Beginner Friendly Full Python Tutorials(Teaser) | Python Tutorials For Absolute Beginners In Hindi#0,2574224,48016,2120,2018-11-24,Nov,100,50136
1936,CodeWithHarry,What is Docker? | Containerization Explained! | Why use Docker Container? (In Hindi),278375,9715,292,2018-11-23,Nov,84,10007
1937,CodeWithHarry,Logistic Regression : Overview And Working - Machine Learning Tutorials Using Python In Hindi,86398,5036,408,2018-11-22,Nov,93,5444
1938,CodeWithHarry,[Hindi] Message Flashing And Other Python Flask Resources | Web Development Using Flask & Python #25,26722,1002,152,2018-11-21,Nov,100,1154
1939,CodeWithHarry,[Hindi] Hosting Flask App On Ubuntu Production Server WSGI - Web Development Using Flask & Python#24,33615,774,118,2018-11-18,Nov,100,892
1940,CodeWithHarry,Adding Music and Background Image In Pygame - Python Game Development Using Pygame In Hindi #21,59820,2289,335,2018-11-15,Nov,95,2624
1941,CodeWithHarry,Bootstrap 4 Tutorial For Beginners In Hindi - हिंदी में (2021),226791,4974,478,2018-11-02,Nov,62,5452
1942,CodeWithHarry,15 Minute Python Tutorial For Beginners In Hindi (Full & Complete Python Crash Course),590148,28429,907,2018-10-11,Oct,86,29336
1943,CodeWithHarry,Which python version is best?,48317,1819,83,2018-10-10,Oct,29,1902
1944,CodeWithHarry,Cheat Codes & Home Screen In Pygame - Python Game Development Using Pygame In Hindi #20,28150,1511,105,2018-10-09,Oct,87,1616
1945,CodeWithHarry,Snakes Game: Creating High Score & Displaying It - Python Game Development Using Pygame In Hindi #19,28453,1123,75,2018-10-06,Oct,100,1198
1946,CodeWithHarry,"🔥Yes, Machine Learning Using Python In Few Minutes Is Possible In 2021! (See How)",44929,5319,546,2018-10-05,Oct,81,5865
1947,CodeWithHarry,Handling Game Over and Collision In Pygame - Python Game Development Using Pygame In Hindi #18,27947,1310,155,2018-10-03,Oct,94,1465
1948,CodeWithHarry,Snakes Game: Length Increment Logic - Python Game Development Using Pygame In Hindi #17,41395,1700,227,2018-10-02,Oct,87,1927
1949,CodeWithHarry,"Adding Score, Replotting Food & Changing Size - Python Game Development Using Pygame In Hindi #16",30331,1797,151,2018-10-02,Oct,97,1948
1950,CodeWithHarry,Creating Food For Snake To Eat - Python Game Development Using Pygame In Hindi #15,27092,2095,73,2018-10-01,Oct,82,2168
1951,CodeWithHarry,Making Snake Move On Arrow Key Press - Python Game Development Using Pygame In Hindi #14,28382,2102,516,2018-10-01,Oct,88,2618
1952,CodeWithHarry,Giving Speed To Our Snake In X and Y directions - Python Game Development Using Pygame In Hindi #13,26032,1611,54,2018-10-01,Oct,99,1665
1953,CodeWithHarry,Making Snake Move In All Directions - Python Game Development Using Pygame In Hindi #12,28761,2264,81,2018-09-30,Sep,87,2345
1954,CodeWithHarry,OverFitting And UnderFitting In Models Explained - Machine Learning Tutorials Using Python In Hindi,54096,3731,245,2018-09-30,Sep,99,3976
1955,CodeWithHarry,Moving Our Snake And Setting Game FPS - Python Game Development Using Pygame In Hindi #11,32107,1313,108,2018-09-30,Sep,89,1421
1956,CodeWithHarry,"K Nearest Neighbors: Pros, Cons and Working -  Machine Learning Tutorials Using Python In Hindi",46906,3418,719,2018-09-29,Sep,95,4137
1957,CodeWithHarry,Creating The Head Of Our Snake - Python Game Development Using Pygame In Hindi #10,35428,1654,120,2018-09-29,Sep,82,1774
1958,CodeWithHarry,Creating Ground For Our Snakes Game - Python Game Development Using Pygame In Hindi #9,61594,2133,96,2018-09-29,Sep,86,2229
1959,CodeWithHarry,Coding Our First Game In Pygame - Python Game Development Using Pygame In Hindi #8,46144,2588,106,2018-09-28,Sep,82,2694
1960,CodeWithHarry,[Hindi] K Nearest Neighbor Classification In Python - Machine Learning Tutorials Using Python Hindi,69379,2977,155,2018-09-28,Sep,99,3132
1961,CodeWithHarry,Event Types and Key Press Handling In Pygame - Python Game Development Using Pygame In Hindi #7,42313,2440,234,2018-09-28,Sep,95,2674
1962,CodeWithHarry,Handling Events In Pygame - Python Game Development Using Pygame In Hindi #6,41945,1968,245,2018-09-27,Sep,76,2213
1963,CodeWithHarry,Creating The Game Loop In Pygame - Python Game Development Using Pygame In Hindi #5,47215,2111,68,2018-09-27,Sep,83,2179
1964,CodeWithHarry,Game Specific Variables In Pygame - Python Game Development Using Pygame In Hindi #4,51494,3273,99,2018-09-26,Sep,84,3372
1965,CodeWithHarry,[Hindi] Supervised Learning : Classification  - Machine Learning Tutorials Using Python In Hindi,59523,4666,395,2018-09-26,Sep,96,5061
1966,CodeWithHarry,Creating The Game Window - Python Game Development Using Pygame In Hindi #3,74431,3230,188,2018-09-26,Sep,75,3418
1967,CodeWithHarry,Pygame Installation and Tips - Python Game Development Using Pygame In Hindi #2,90740,2375,160,2018-09-25,Sep,79,2535
1968,CodeWithHarry,Flappy Bird Game In Python - Python Game Development Using Pygame In Hindi #1,205343,4957,232,2018-09-25,Sep,77,5189
1969,CodeWithHarry,"[Hindi] Property Decorators, Setters & Deleters? | Object Oriented Programming Using Python #9",28527,1166,92,2018-09-23,Sep,94,1258
1970,CodeWithHarry,[Hindi] Magic/Dunder Methods In Python? | Object Oriented Programming Using Python Tutorial #8,39362,1231,102,2018-09-22,Sep,94,1333
1971,CodeWithHarry,Invalid python interpreter selected for the project pycharm (Solved),4974,177,33,2018-09-21,Sep,68,210
1972,CodeWithHarry,[Hindi] Mini Batch and Stochastic Gradient Descent -Machine Learning Tutorials Using Python In Hindi,62988,3230,207,2018-09-18,Sep,100,3437
1973,CodeWithHarry,[Hindi] Python Matplotlib Tutorial - Python Data Science and Big Data Tutorials,106670,4027,214,2018-09-17,Sep,79,4241
1974,CodeWithHarry,"[Solved] ""ModuleNotFoundError: No module named"" Error Even When Module Installed In Pycharm",233048,3121,349,2018-09-16,Sep,91,3470
1975,CodeWithHarry,[Hindi] Loss Functions and Gradient Descent - Machine Learning Tutorials Using Python In Hindi,111711,7733,954,2018-09-15,Sep,94,8687
1976,CodeWithHarry,[Hindi] How Does Linear Regression Model Work? (Derivation) - Machine Learning Tutorials In Hindi,94341,4411,219,2018-09-14,Sep,97,4630
1977,CodeWithHarry,[Hindi] Linear Regression Code In Python Sklearn! - Machine Learning Tutorials In Hindi,232192,8952,587,2018-09-13,Sep,87,9539
1978,CodeWithHarry,What is Client Side Vs Server Side Programming? | Front end Vs Back End Explained!,122344,4447,123,2018-09-12,Sep,82,4570
1979,CodeWithHarry,[Hindi] Multiple Regression Model Explained! - Machine Learning Tutorials Using Python In Hindi,152527,9096,381,2018-09-12,Sep,95,9477
1980,CodeWithHarry,[Hindi] Simple Linear Regression Explained! - Machine Learning Tutorials Using Python In Hindi,230401,8315,286,2018-09-11,Sep,94,8601
1981,CodeWithHarry,[Hindi] Training And Test Data In ML - Machine Learning Tutorials Using Python In Hindi,161537,9454,592,2018-09-10,Sep,87,10046
1982,CodeWithHarry,[Hindi] Installing Python Scikit learn For ML -  Machine Learning Tutorials Using Python In Hindi,168865,7262,139,2018-09-09,Sep,97,7401
1983,CodeWithHarry,"[Hindi] Top 5 Best Books For Python, Data Science and Machine Learning",34050,1627,79,2018-09-09,Sep,70,1706
1984,CodeWithHarry,[Hindi] Supervised And Unsupervised Learning! - Machine Learning Tutorials Using Python In Hindi,176615,7236,199,2018-09-09,Sep,96,7435
1985,CodeWithHarry,[Hindi] Data Collection For Machine Learning? - Machine Learning Tutorials Using Python In Hindi,182710,8100,146,2018-09-08,Sep,96,8246
1986,CodeWithHarry,How To Earn Money In Stock Market Using Python and Data Analysis Of Stock Exchange Data?,89393,4276,619,2018-09-07,Sep,88,4895
1987,CodeWithHarry,[Hindi] What Are Features And Labels In ML? - Machine Learning Tutorials Using Python In Hindi,197611,8023,349,2018-09-07,Sep,94,8372
1988,CodeWithHarry,Do You Need Mathematics To Learn Machine Learning?,42717,2643,131,2018-09-06,Sep,50,2774
1989,CodeWithHarry,[Hindi] Some Machine Learning Facts & Motivation - Machine Learning Tutorials Using Python In Hindi,208648,6857,189,2018-09-06,Sep,99,7046
1990,CodeWithHarry,[Hindi] Setting Up VS Code For Python + Pros and Cons?,2837,116,23,2018-09-05,Sep,54,139
1991,CodeWithHarry,[Hindi] Why Learn Machine Learning? - Machine Learning Tutorials Using Python In Hindi,497988,14260,316,2018-09-05,Sep,86,14576
1992,CodeWithHarry,[Hindi] Working With JSON In Python - Python Data Science and Big Data Tutorials,25764,1215,41,2018-09-05,Sep,80,1256
1993,CodeWithHarry,[Hindi] Merging DataFrames In Pandas - Python Data Science and Big Data Tutorials,27277,1190,58,2018-09-04,Sep,81,1248
1994,CodeWithHarry,[Hindi] Writing A CSV File In Python Pandas - Python Data Science and Big Data Tutorials,28639,1411,41,2018-09-04,Sep,88,1452
1995,CodeWithHarry,[Hindi] Reading A CSV File In Python Pandas - Python Data Science and Big Data Tutorials,53733,1974,252,2018-09-02,Sep,88,2226
1996,CodeWithHarry,[Hindi] Slicing And Adding Columns To A DataFrame - Python Data Science and Big Data Tutorials,31072,2765,140,2018-09-01,Sep,94,2905
1997,CodeWithHarry,[Hindi] Creating Our First Pandas DataFrame - Python Data Science and Big Data Tutorials,32890,2365,179,2018-09-01,Sep,88,2544
1998,CodeWithHarry,[Hindi] Introduction To Pandas Module - Python Data Science and Big Data Tutorials,53777,1964,64,2018-08-31,Aug,82,2028
1999,CodeWithHarry,[Hindi] Machine Learning and Artificial Intelligence Will Take Away Your Jobs?,7525,445,61,2018-08-30,Aug,78,506
2000,CodeWithHarry,[Hindi] How To Make Money From Programming? (More than Jobs),161504,8979,576,2018-08-29,Aug,60,9555
2001,CodeWithHarry,[Solved] AttributeError: 'module' object has no attribute,176697,1434,117,2018-08-28,Aug,57,1551
2002,CodeWithHarry,[Hindi] Convert Python Program to Exe Executable,65721,2321,168,2018-08-27,Aug,48,2489
2003,CodeWithHarry,"[Hindi] Numpy Argsort, Argmin, Argmax And Other Tips - Python Data Science and Big Data Tutorials",29871,1366,55,2018-08-27,Aug,97,1421
2004,CodeWithHarry,Python Program To Check Whether A Number Is A Palindrome Or Not,46368,1166,75,2018-08-26,Aug,63,1241
2005,CodeWithHarry,Python Program To Calculate Factorial,23359,556,31,2018-08-26,Aug,37,587
2006,CodeWithHarry,Do You Need A CS Degree To Get A Programming Job Or Interview?,128272,8440,620,2018-08-26,Aug,62,9060
2007,CodeWithHarry,"[Hindi] Axis, Sorting & Useful Numpy Functions-Python Data Science and Big Data Tutorials in Hindi",39370,2165,129,2018-08-25,Aug,98,2294
2008,CodeWithHarry,[Hindi] Can We Write Our Own Python Package (Make your own python package)?,3142,158,37,2018-08-24,Aug,75,195
2009,CodeWithHarry,[Hindi] Python Numpy Array Functions and Slicing-Python Data Science and Big Data Tutorials in Hindi,74058,2979,329,2018-08-21,Aug,100,3308
2010,CodeWithHarry,[Hindi] Numpy Python Tutorial For Beginners | Python Data Science and Big Data Tutorials In Hindi,90893,3288,410,2018-08-20,Aug,97,3698
2011,CodeWithHarry,[Hindi] Jupyter Notebook Installation and demo | Python Data Science and Big Data Tutorials In Hindi,220321,6902,735,2018-08-19,Aug,100,7637
2012,CodeWithHarry,"[Hindi] What, Why And How of Big Data Analysis | Python Data Science and Big Data Tutorials In Hindi",197035,7759,334,2018-08-18,Aug,100,8093
2013,CodeWithHarry,Join Function In Python Explained | Advanced python tutorials in Hindi,11850,484,64,2018-08-17,Aug,70,548
2014,CodeWithHarry,Format Function In Python Explained | Advanced python tutorials in Hindi,24278,691,77,2018-08-17,Aug,72,768
2015,CodeWithHarry,[Hindi] Deleting A Local/Remote Branch In Git - Git and GitHub Tutorials for beginners #11,24087,1075,211,2018-08-16,Aug,90,1286
2016,CodeWithHarry,[Hindi] Branches In Git - Git and GitHub Tutorials for beginners #10,32323,1383,149,2018-08-16,Aug,68,1532
2017,CodeWithHarry,Enumerate Function In Python Explained | Advanced python tutorials in Hindi,12888,426,19,2018-08-16,Aug,75,445
2018,CodeWithHarry,[Hindi] Fixing The Add Post Bug - Web Development Using Flask and Python #23,13757,368,33,2018-08-16,Aug,76,401
2019,CodeWithHarry,[Hindi] Bisect Module In Python Explained | Advanced python tutorials in Hindi,12291,521,46,2018-08-15,Aug,78,567
2020,CodeWithHarry,[Hindi] Advanced List Slicing In Python Explained | Advanced python tutorials in Hindi,14077,551,55,2018-08-15,Aug,86,606
2021,CodeWithHarry,[Hindi] Ignoring Files In Git By Adding .gitignore File - Git and GitHub Tutorials for beginners #9,22903,891,21,2018-08-14,Aug,99,912
2022,CodeWithHarry,[Hindi] Cloning A Git Repository - Git and GitHub Tutorials for beginners #8,153965,2432,48,2018-08-13,Aug,76,2480
2023,CodeWithHarry,[Hindi] Git add -A and Git add . difference - Git and GitHub Tutorials for beginners #7,21680,723,17,2018-08-12,Aug,87,740
2024,CodeWithHarry,[Hindi] Scanning Changes To Files Using git diff command - Git and GitHub Tutorials for beginners #6,36184,1176,28,2018-08-12,Aug,100,1204
2025,CodeWithHarry,[Hindi] Pushing and Pulling Code From Git - Git and GitHub Tutorials for beginners #5,258537,4020,142,2018-08-11,Aug,85,4162
2026,CodeWithHarry,[Hindi] Git Three Stage Architecture - Git and GitHub Tutorials for beginners #4,55121,2212,53,2018-08-09,Aug,80,2265
2027,CodeWithHarry,[Hindi] Our First Git Repository - Git and GitHub Tutorials for beginners #3,100581,5739,126,2018-08-08,Aug,76,5865
2028,CodeWithHarry,[Hindi] Installing Git - Git and GitHub Tutorials for beginners #2,108879,2910,50,2018-08-07,Aug,66,2960
2029,CodeWithHarry,[Hindi] Introduction To Git - Git and GitHub Tutorials for beginners #1,184082,4813,84,2018-08-07,Aug,71,4897
2030,CodeWithHarry,[Hindi] Hosting The Blog On A Server - Web Development Using Flask and Python #22,24179,533,97,2018-08-06,Aug,81,630
2031,CodeWithHarry,[Hindi] Pickle Module In Python Explained!,8669,288,41,2018-08-06,Aug,42,329
2032,CodeWithHarry,[Hindi] Purchasing A Domain Name From Godaddy- Web Development Using Flask and Python #21,20224,603,29,2018-08-05,Aug,89,632
2033,CodeWithHarry,[Hindi] Uploading Flask Blog To GitHub - Web Development Using Flask and Python #20,26061,671,61,2018-08-05,Aug,83,732
2034,CodeWithHarry,[Hindi] Creating Pagination In Flask - Web Development Using Flask and Python #19,21793,844,86,2018-08-05,Aug,81,930
2035,CodeWithHarry,[Hindi] Deleting BlogPosts In Flask - Web Development Using Flask and Python #18,13674,694,44,2018-08-05,Aug,80,738
2036,CodeWithHarry,[Hindi] Uploading Files In Flask - Web Development Using Flask and Python #17,35049,945,138,2018-08-05,Aug,77,1083
2037,CodeWithHarry,[Hindi] Adding New Posts To Flask Blog - Web Development Using Flask and Python #16,29279,726,180,2018-08-05,Aug,83,906
2038,CodeWithHarry,"[Hindi] Edit, Delete and File Upload - Web Development Using Flask and Python #15",36152,1154,173,2018-08-04,Aug,81,1327
2039,CodeWithHarry,[Hindi] Fastest way to learn web development in 2021!,12859,639,71,2018-08-04,Aug,53,710
2040,CodeWithHarry,What Is Virtual Private Server? | VPS explained in Hindi,17543,770,50,2018-08-03,Aug,56,820
2041,CodeWithHarry,[Hindi] Creating Admin Dashboard - Web Development Using Flask and Python #14,39772,1231,69,2018-08-03,Aug,77,1300
2042,CodeWithHarry,[Hindi] How To Find Execution Time Of A Python Program Using Time Module?,68618,1268,56,2018-08-02,Aug,73,1324
2043,CodeWithHarry,[Hindi] Designing The Blog's Homepage - Web Development Using Flask and Python #13,31127,1137,85,2018-08-02,Aug,82,1222
2044,CodeWithHarry,CodeWithHarry Live Stream,0,0,0,2018-08-01,Aug,25,0
2045,CodeWithHarry,[Hindi] But What is* Git and GitHub??,359552,14940,203,2018-08-01,Aug,37,15143
2046,CodeWithHarry,[Solved] No module named MySQLdb,56652,910,277,2018-08-01,Aug,32,1187
2047,CodeWithHarry,[Hindi] Creating Our First Flask Post In Hindi - Web Development Using Flask and Python #12,43369,1407,210,2018-08-01,Aug,91,1617
2048,CodeWithHarry,[Hindi] Sending Emails Using Flask - Web Development Using Flask and Python #11,44468,1502,266,2018-07-30,Jul,79,1768
2049,CodeWithHarry,[Hindi] Making Parameters Configurable - Web Development Using Flask and Python #10,48270,2428,292,2018-07-30,Jul,83,2720
2050,CodeWithHarry,[Hindi] Flask SQLAlchemy Tutorial In Hindi - Web Development Using Flask and Python #9,104260,2870,620,2018-07-29,Jul,86,3490
2051,CodeWithHarry,[Hindi] Connecting to the Database - Web Development Using Flask and Python #8,108613,3113,175,2018-07-28,Jul,78,3288
2052,CodeWithHarry,[Hindi] Template Inheritance In Jinja2 - Web Development Using Flask and Python #7,73309,2998,340,2018-07-28,Jul,82,3338
2053,CodeWithHarry,[Hindi] Creating A Tech Blog - Web Development Using Flask and Python #6,100243,3666,492,2018-07-27,Jul,72,4158
2054,CodeWithHarry,[Hindi] Jinja Templating Basics - Web Development Using Flask and Python #5,111316,3190,116,2018-07-26,Jul,75,3306
2055,CodeWithHarry,[Hindi] Simple Bootstrap Site - Web Development Using Flask and Python #4,110406,2521,152,2018-07-25,Jul,73,2673
2056,CodeWithHarry,[Hindi] Static and Templates folder - Web Development Using Flask and Python #3,157393,3892,341,2018-07-24,Jul,79,4233
2057,CodeWithHarry,[Hindi] Creating Our First Flask App - Web Development Using Flask and Python #2,215416,5892,371,2018-07-24,Jul,80,6263
2058,CodeWithHarry,[Hindi] How Websites Work - Web Development Using Flask and Python #1,326029,8510,293,2018-07-23,Jul,69,8803
2059,CodeWithHarry,[Hindi] Lambda functions in python in Hindi | Advanced python in Hindi,17808,616,47,2018-07-22,Jul,70,663
2060,CodeWithHarry,"Map, Filter and Reduce in Python |  Advanced Python in Hindi",17207,705,41,2018-07-18,Jul,60,746
2061,CodeWithHarry,"List Comprehension, Dictionary Comprehension And Generator Comprehension | Advanced Python in Hindi",18747,645,53,2018-07-16,Jul,99,698
2062,CodeWithHarry,"[Hindi] Iterators, Iterables and Generators in python explained | Advanced python tutorials in Hindi",56690,1848,62,2018-07-15,Jul,100,1910
2063,CodeWithHarry,[Hindi] Virtual Environment (venv) in python explained | Advanced python tutorials in Hindi,38460,1041,79,2018-07-11,Jul,91,1120
2064,CodeWithHarry,"[Hindi] Try, Except, Else and Finally in python explained | Advanced python tutorials in Hindi",34704,1077,43,2018-07-09,Jul,94,1120
2065,CodeWithHarry,[Hindi] *args and **kwargs in python explained | Advanced python tutorials in Hindi,34139,1129,74,2018-07-08,Jul,83,1203
2066,CodeWithHarry,"[Hindi] if __name__ == ""__main__"" in python explained | Advanced python in Hindi",111600,2621,108,2018-07-07,Jul,80,2729
2067,CodeWithHarry,[Hindi] Inheritance In Python oops | Object Oriented Programming In Python Tutorial #7,38927,1216,55,2018-06-20,Jun,86,1271
2068,CodeWithHarry,[Hindi] Static Methods In Python oops | Object Oriented Programming In Python Tutorial #6,36408,1163,37,2018-06-16,Jun,89,1200
2069,CodeWithHarry,[Hindi] Class Methods As Alternative Constructor | Object Oriented Programming In Python Tutorial #5,47167,1287,50,2018-06-15,Jun,100,1337
2070,CodeWithHarry,[Hindi] Class Methods In Python | Object Oriented Programming Using Python Tutorial #4,64947,1760,96,2018-06-14,Jun,86,1856
2071,CodeWithHarry,[Hindi] Instance and Class Variables | Object Oriented Programming Using Python Tutorial #3,93354,2742,223,2018-06-13,Jun,91,2965
2072,CodeWithHarry,"[Hindi] Classes, Objects and Constructors | Object Oriented Programming Using Python Tutorial #2",133749,3814,145,2018-06-10,Jun,96,3959
2073,CodeWithHarry,[Hindi] Why OOPs In Python? | Object Oriented Programming Using Python Programming Tutorial #1,181367,5183,158,2018-06-09,Jun,94,5341
2074,CodeWithHarry,Creating a Realtime PHP Chatroom Using PHP & Jquery #7,28077,594,133,2018-06-09,Jun,54,727
2075,CodeWithHarry,Creating a Realtime PHP Chatroom Using PHP & Jquery #6,13646,260,50,2018-06-08,Jun,54,310
2076,CodeWithHarry,Creating a Realtime PHP Chatroom Using PHP & Jquery #5,11335,284,29,2018-06-08,Jun,54,313
2077,CodeWithHarry,Creating a Realtime PHP Chatroom Using PHP & Jquery #4,12710,305,41,2018-06-07,Jun,54,346
2078,CodeWithHarry,Creating a Realtime PHP Chatroom Using PHP & Jquery #3,16426,520,56,2018-06-07,Jun,54,576
2079,CodeWithHarry,Creating a Realtime PHP Chatroom Using PHP & Jquery #2,33410,662,45,2018-06-07,Jun,54,707
2080,CodeWithHarry,Creating a Realtime PHP Chatroom Using PHP & Jquery #1,87956,1650,92,2018-06-06,Jun,54,1742
2081,CodeWithHarry,Learn Php In One Video In Hindi - हिंदी में,250713,7428,303,2018-06-05,Jun,43,7731
2082,CodeWithHarry,[Solved] 'No python interpreter configured for the project' in Pycharm,65700,581,85,2018-06-05,Jun,70,666
2083,CodeWithHarry,Learn Python In Hindi In One Video - हिंदी में,314929,10051,610,2018-06-04,Jun,46,10661
2084,CodeWithHarry,"[Solved] The term 'pip' is not recognized as the name of a cmdlet, function, or operable program",354371,7175,808,2018-06-01,Jun,96,7983
2085,CodeWithHarry,JavaScript Tutorial,397411,10298,586,2018-05-13,May,19,10884
2086,CodeWithHarry,[Hindi] Which Programming Language to Learn First?,48951,1624,119,2018-05-12,May,50,1743
2087,CodeWithHarry,[Hindi] Top 5 Programming Languages Everyone Should Learn!,87543,4158,486,2018-05-11,May,58,4644
